Date,Open,High,Low,Close,Volume,Change,ChangeRatio
2024-01-02,99000,99400,97400,97600,1341485,-1400,-1.4141414141414141
2024-01-03,96500,96800,93700,93800,1694613,-2700,-2.7979274611398965
2024-01-04,93000,93400,91800,92900,1589156,-100,-0.10752688172043011
2024-01-05,93500,93700,91200,91600,1110042,-1900,-2.0320855614973263
2024-01-08,92000,92300,88800,88900,1397056,-3100,-3.369565217391304
2024-01-09,89800,89900,88100,89100,1384540,-700,-0.779510022271715
2024-01-10,89400,91100,88800,90500,1123770,1100,1.2304250559284116
2024-01-11,91400,91800,89700,89700,1472306,-1700,-1.8599562363238513
2024-01-12,89400,89700,88000,88300,923693,-1100,-1.2304250559284116
2024-01-15,88700,91300,88400,90900,956800,2200,2.480270574971815
2024-01-16,90200,91200,89400,89800,836055,-400,-0.4434589800443459
2024-01-17,89000,89500,87500,87900,961515,-1100,-1.2359550561797752
2024-01-18,87500,88500,86900,87300,840897,-200,-0.2285714285714286
2024-01-19,88100,88700,87000,87600,831282,-500,-0.5675368898978433
2024-01-22,87700,88300,85900,87200,1060021,-500,-0.5701254275940707
2024-01-23,87100,88100,86900,87900,917374,800,0.9184845005740528
2024-01-24,87500,88200,86800,87900,882524,400,0.4571428571428572
2024-01-25,87100,93000,86100,93000,3397759,5900,6.77382319173364
2024-01-26,94600,95700,92700,94400,2383070,-200,-0.21141649048625794
2024-01-29,94700,100000,94400,99900,3200604,5200,5.4910242872228086
2024-01-30,101000,103600,97800,98000,3463949,-3000,-2.9702970297029703
2024-01-31,99400,103000,98500,102900,3793928,3500,3.5211267605633805
2024-02-01,102800,106800,101600,106300,3751067,3500,3.404669260700389
2024-02-02,110000,119900,108700,119500,8478816,9500,8.636363636363637
2024-02-05,119600,121300,113700,118300,6726216,-1300,-1.0869565217391304
2024-02-06,115600,118000,110900,111600,5169164,-4000,-3.4602076124567476
2024-02-07,112000,115800,110100,114700,4555156,2700,2.410714285714286
2024-02-08,112700,114700,111300,113200,2788161,500,0.44365572315882873
2024-02-13,116300,120000,115100,117200,3370853,900,0.7738607050730868
2024-02-14,115600,118800,114700,117600,1530264,2000,1.7301038062283738
2024-02-15,119300,119700,113100,113500,2518069,-5800,-4.861693210393965
2024-02-16,113500,115900,111500,115800,2159137,2300,2.026431718061674
2024-02-19,115600,119300,115300,117600,1750923,2000,1.7301038062283738
2024-02-20,115600,118700,113000,116100,1952950,500,0.43252595155709345
2024-02-21,116200,118600,115000,116800,1845668,600,0.5163511187607573
2024-02-22,116800,121900,115300,119300,3154400,2500,2.1404109589041096
2024-02-23,119400,120700,118000,118400,2253030,-1000,-0.8375209380234505
2024-02-26,116000,116500,112300,114600,2748769,-1400,-1.206896551724138
2024-02-27,111800,115800,111800,112600,2108829,800,0.7155635062611807
2024-02-28,112600,117800,112000,117700,1833765,5100,4.529307282415631
2024-02-29,118300,126900,117500,124500,5862121,6200,5.240912933220625
2024-03-04,124500,126900,124000,125600,3032627,1100,0.8835341365461846
2024-03-05,124000,124900,122300,123000,2940381,-1000,-0.8064516129032258
2024-03-06,121700,127900,121700,127000,2543361,5300,4.354971240755957
2024-03-07,127000,129200,125500,126100,1849757,-900,-0.7086614173228346
2024-03-08,126900,130000,126200,128400,2324865,1500,1.1820330969267139
2024-03-11,128900,131700,126100,126200,1885521,-2700,-2.094647013188518
2024-03-12,125100,127600,125100,126100,1085368,1000,0.7993605115907274
2024-03-13,125900,127300,124500,125900,1396568,0,0.0
2024-03-14,125900,129600,125500,128500,1913544,2600,2.0651310563939633
2024-03-15,128100,130700,125000,125000,2180445,-3100,-2.419984387197502
2024-03-18,126200,128200,124700,128000,1548673,1800,1.4263074484944533
2024-03-19,123200,123600,118200,118900,3390443,-4300,-3.49025974025974
2024-03-20,119500,120300,115100,115700,2379123,-3800,-3.1799163179916317
2024-03-21,117300,118000,115500,115700,2960845,-1600,-1.3640238704177323
2024-03-22,116200,116800,112100,112900,2811721,-3300,-2.8399311531841653
2024-03-25,113100,113500,111000,111500,1550861,-1600,-1.414677276746242
2024-03-26,111200,115400,111200,114400,2021266,3200,2.877697841726619
2024-03-27,114400,115000,112900,113600,1270063,-800,-0.6993006993006993
2024-03-28,114200,114300,111800,112000,1350186,-2200,-1.926444833625219
2024-03-29,112200,113400,110000,110200,1307187,-2000,-1.7825311942959003
2024-04-01,110900,111500,108200,108700,1112885,-2200,-1.9837691614066726
2024-04-02,108200,108700,104000,104700,2520832,-3500,-3.234750462107209
2024-04-03,104300,105400,101800,101800,1671419,-2500,-2.3969319271332696
2024-04-04,103600,106900,102700,106700,2078100,3100,2.9922779922779923
2024-04-05,105300,108500,104300,105000,1944665,-300,-0.2849002849002849
2024-04-08,105000,111000,105000,108500,2070252,3500,3.3333333333333335
2024-04-09,111100,112500,107800,108000,1652638,-3100,-2.7902790279027903
2024-04-11,104600,111800,104400,111700,2217580,7100,6.787762906309751
2024-04-12,111500,111700,108000,109800,1226958,-1700,-1.5246636771300448
2024-04-15,109200,115000,107200,114600,2446762,5400,4.945054945054945
2024-04-16,113500,115200,112200,114700,1988405,1200,1.0572687224669604
2024-04-17,114800,114900,111300,113100,1576611,-1700,-1.480836236933798
2024-04-18,114000,114600,110700,112200,1665994,-1800,-1.5789473684210527
2024-04-19,111000,113700,107800,110400,2114673,-600,-0.5405405405405406
2024-04-22,111600,115500,111600,115100,1916502,3500,3.136200716845878
2024-04-23,116000,118300,114500,115900,1392773,-100,-0.08620689655172414
2024-04-24,114800,116800,114200,116200,1178637,1400,1.2195121951219512
2024-04-25,114800,118000,114200,116600,1708852,1800,1.5679442508710801
2024-04-26,116600,121500,114500,118200,2705868,1600,1.3722126929674099
2024-04-29,119500,121300,117600,118300,1820652,-1200,-1.00418410041841
2024-04-30,118100,119500,117200,118000,1264927,-100,-0.0846740050804403
2024-05-02,118300,119600,117500,119600,1246995,1300,1.098901098901099
2024-05-03,120300,120800,113600,113900,1779155,-6400,-5.320033250207814
2024-05-07,114000,116600,114000,115700,1204913,1700,1.4912280701754386
2024-05-08,114700,117200,114700,116000,792482,1300,1.1333914559721012
2024-05-09,116400,116400,111200,111700,1762344,-4700,-4.037800687285223
2024-05-10,113500,114500,112000,114100,1422408,600,0.5286343612334802
2024-05-13,113900,115700,113300,114300,935835,400,0.35118525021949076
2024-05-14,114500,115200,112500,113900,788713,-600,-0.5240174672489083
2024-05-16,114900,115500,113400,114700,963262,-200,-0.17406440382941687
2024-05-17,115100,115900,112500,112700,1087425,-2400,-2.0851433536055604
2024-05-20,113400,116500,113000,114900,850630,1500,1.3227513227513228
2024-05-21,114900,115000,113800,114400,695579,-500,-0.4351610095735422
2024-05-22,113600,119700,113400,118900,2260904,5300,4.665492957746479
2024-05-23,119000,120900,116200,120500,1760819,1500,1.2605042016806722
2024-05-24,119300,122100,118800,120000,1463021,700,0.586756077116513
2024-05-27,120500,124400,118600,122500,1644197,2000,1.6597510373443984
2024-05-28,123000,124800,122000,122400,1096369,-600,-0.4878048780487805
2024-05-29,121200,123000,119200,122000,1277990,800,0.6600660066006601
2024-05-30,121100,122200,117700,117700,1096042,-3400,-2.8075970272502064
2024-05-31,119200,120800,117700,117700,2011874,-1500,-1.2583892617449663
2024-06-03,120100,122800,119800,120700,906152,600,0.4995836802664446
2024-06-04,120700,121700,118100,119000,820199,-1700,-1.4084507042253522
2024-06-05,119000,120200,118300,119500,1068743,500,0.42016806722689076
2024-06-07,120500,122300,119500,121100,976721,600,0.49792531120331945
2024-06-10,121000,123000,120000,121400,970865,400,0.3305785123966942
2024-06-11,122700,123200,121300,122000,1214447,-700,-0.5704971475142625
2024-06-12,124000,124000,121400,122500,970708,-1500,-1.2096774193548387
2024-06-13,123100,125400,121600,121700,2186257,-1400,-1.1372867587327375
2024-06-14,121400,124600,120800,122700,1278973,1300,1.070840197693575
2024-06-17,124000,129400,123800,129100,2654199,5100,4.112903225806452
2024-06-18,129900,133900,129100,131000,2632809,1100,0.8468052347959968
2024-06-19,132200,135000,130800,132300,1606458,100,0.07564296520423601
2024-06-20,131400,131600,128700,130600,1110575,-800,-0.60882800608828
2024-06-21,130400,130500,126500,127900,1680099,-2500,-1.9171779141104295
2024-06-24,127800,128900,126100,128300,712382,500,0.39123630672926446
2024-06-25,129200,130600,127900,129000,1100760,-200,-0.15479876160990713
2024-06-26,127800,130900,127600,130800,1219468,3000,2.3474178403755865
2024-06-27,129100,132300,128200,131500,901065,2400,1.8590240123934934
2024-06-28,132300,132300,128600,129300,1026360,-3000,-2.2675736961451247
2024-07-01,128100,129900,127700,128600,659327,500,0.39032006245121
2024-07-02,128000,128300,123500,123600,1369592,-4400,-3.4375000000000004
2024-07-03,124800,125500,122500,123700,1035953,-1100,-0.8814102564102564
2024-07-04,124100,126600,124100,125600,793881,1500,1.20870265914585
2024-07-05,126700,128200,125300,126300,805600,-400,-0.31570639305445936
2024-07-08,126200,127500,124200,124200,999050,-2000,-1.5847860538827259
2024-07-09,125000,125400,120600,122500,1662846,-2500,-2.0
2024-07-10,121600,122900,120800,122000,1118813,400,0.3289473684210526
2024-07-11,123000,123200,121300,122300,998099,-700,-0.5691056910569106
2024-07-12,122800,123500,120000,121300,863955,-1500,-1.221498371335505
2024-07-15,121300,121600,118700,120000,669497,-1300,-1.0717230008244023
2024-07-16,120900,122900,120600,122900,891422,2000,1.6542597187758479
2024-07-17,123000,123000,120100,121000,944338,-2000,-1.6260162601626018
2024-07-18,120000,120700,118500,119900,864546,-100,-0.08333333333333334
2024-07-19,118300,118400,114700,116300,1498610,-2000,-1.69061707523246
2024-07-22,116700,117500,113800,115900,968117,-800,-0.6855184233076265
2024-07-23,117200,120600,117200,120500,1194748,3300,2.8156996587030716
2024-07-24,118800,119400,117900,118400,689203,-400,-0.33670033670033667
2024-07-25,118300,118900,114500,115000,1138700,-3300,-2.789518174133559
2024-07-26,118500,118500,110000,112100,1582067,-6400,-5.40084388185654
2024-07-29,112100,116100,110900,113700,1192545,1600,1.4272970561998217
2024-07-30,112800,115300,111600,111600,765612,-1200,-1.0638297872340425
2024-07-31,110500,113000,110500,112100,882651,1600,1.4479638009049773
2024-08-01,113300,114500,112100,112100,615829,-1200,-1.059135039717564
2024-08-02,109000,110000,106700,107100,1332881,-1900,-1.743119266055046
2024-08-05,103900,104400,95000,96300,2493835,-7600,-7.314725697786333
2024-08-06,100900,105200,97600,102700,1867054,1800,1.7839444995044598
2024-08-07,100400,103100,99900,101600,1475882,1200,1.1952191235059761
2024-08-08,100100,102100,99300,101600,1074481,1500,1.4985014985014986
2024-08-09,103500,104900,101500,101900,1080152,-1600,-1.5458937198067633
2024-08-12,102300,103000,101300,102100,639297,-200,-0.19550342130987292
2024-08-13,102200,103200,101100,102800,727338,600,0.5870841487279843
2024-08-14,103800,103900,101700,102300,713158,-1500,-1.4450867052023122
2024-08-16,103700,107000,103200,105900,1467142,2200,2.1215043394406945
2024-08-19,106300,106600,102600,103200,806135,-3100,-2.916274694261524
2024-08-20,104100,104900,102600,103400,895891,-700,-0.6724303554274735
2024-08-21,103400,103900,102300,103000,566956,-400,-0.3868471953578337
2024-08-22,103100,103500,102000,102400,458855,-700,-0.6789524733268671
2024-08-23,102000,104300,101900,104000,680599,2000,1.9607843137254901
2024-08-26,104400,105300,102500,102800,538340,-1600,-1.532567049808429
2024-08-27,103100,103200,100300,101800,657152,-1300,-1.2609117361784674
2024-08-28,101800,105300,101600,104600,827919,2800,2.75049115913556
2024-08-29,105500,107900,103700,106600,1623481,1100,1.042654028436019
2024-08-30,106600,110700,106100,106100,3386834,-500,-0.46904315196998125
2024-09-02,106700,107200,104500,106100,1014420,-600,-0.5623242736644799
2024-09-03,105700,106600,101800,102200,1021486,-3500,-3.3112582781456954
2024-09-04,99100,101300,98600,100200,1394527,1100,1.109989909182644
2024-09-05,100700,103100,99700,100700,1103725,0,0.0
2024-09-06,100300,101600,98500,100000,1130536,-300,-0.29910269192422734
2024-09-09,98600,101400,98300,100800,665413,2200,2.231237322515213
2024-09-10,100800,101200,99700,100200,709669,-600,-0.5952380952380952
2024-09-11,100500,100500,95800,96200,1788449,-4300,-4.27860696517413
2024-09-12,97800,100200,97600,99100,1965672,1300,1.329243353783231
2024-09-13,100300,102000,99500,100500,1051359,200,0.19940179461615154
2024-09-19,101500,104500,101000,103500,1700541,2000,1.9704433497536946
2024-09-20,103100,106300,102600,105600,1898045,2500,2.424830261881668
2024-09-23,106300,106300,102800,103200,758934,-3100,-2.916274694261524
2024-09-24,103600,104500,102000,103800,1004487,200,0.19305019305019305
2024-09-25,104800,105300,102600,102800,873655,-2000,-1.9083969465648856
2024-09-26,101800,104900,101700,104900,954693,3100,3.045186640471513
2024-09-27,105000,106300,104000,104800,1180495,-200,-0.19047619047619047
2024-09-30,105700,105800,99900,99900,1408649,-5800,-5.4872280037842955
2024-10-02,98200,100300,98100,98700,947817,500,0.5091649694501018
2024-10-04,99400,100000,97800,98000,953289,-1400,-1.4084507042253522
2024-10-07,99300,100900,98600,100400,747649,1100,1.1077542799597182
2024-10-08,99700,100900,99500,99600,953986,-100,-0.10030090270812438
2024-10-10,101900,102900,100600,100800,1347031,-1100,-1.0794896957801767
2024-10-11,101300,102200,100700,101100,586806,-200,-0.19743336623889435
2024-10-14,101400,102500,100500,100600,512895,-800,-0.7889546351084813
2024-10-15,100800,100800,99200,99700,742330,-1100,-1.0912698412698412
2024-10-16,98800,99400,97500,97800,1442581,-1000,-1.0121457489878543
2024-10-17,98100,98400,93700,95200,2337274,-2900,-2.9561671763506627
2024-10-18,94000,96700,94000,95100,954041,1100,1.1702127659574468
2024-10-21,95300,96400,94400,95000,887808,-300,-0.3147953830010493
2024-10-22,93600,94100,91800,92500,2094323,-1100,-1.1752136752136753
2024-10-23,92000,93800,91100,93000,2096814,1000,1.0869565217391304
2024-10-24,90000,92200,90000,90900,2432361,900,1.0
2024-10-25,90100,93500,89900,92700,2070730,2600,2.885682574916759
2024-10-28,93700,96800,93500,95500,1990596,1800,1.92102454642476
2024-10-29,95000,95800,93000,93700,1032980,-1300,-1.368421052631579
2024-10-30,93000,94400,92100,94100,1288804,1100,1.1827956989247312
2024-10-31,93500,94500,91900,91900,1497645,-1600,-1.7112299465240641
2024-11-01,91000,95200,90600,94300,1273159,3300,3.626373626373627
2024-11-04,95000,97500,94400,97400,1455797,2400,2.526315789473684
2024-11-05,96800,97200,96100,97000,853795,200,0.2066115702479339
2024-11-06,96400,96800,93800,95000,1201388,-1400,-1.4522821576763485
2024-11-07,94000,95100,92600,94000,1538830,0,0.0
2024-11-08,94200,95300,92500,93000,954617,-1200,-1.2738853503184715
2024-11-11,92100,95200,92100,94600,952667,2500,2.714440825190011
2024-11-12,94700,95100,91900,91900,1029314,-2800,-2.956705385427666
2024-11-13,91500,91800,89600,90800,930142,-700,-0.7650273224043715
2024-11-14,91600,93900,90400,92500,1308730,900,0.9825327510917031
2024-11-15,90500,92400,89500,91600,1000774,1100,1.2154696132596685
2024-11-18,91100,96800,91100,96700,1258964,5600,6.147091108671789
2024-11-19,95800,97200,95000,95300,791662,-500,-0.5219206680584552
2024-11-20,95300,99200,95000,98100,1315123,2800,2.9380902413431267
2024-11-21,98100,98900,96800,97600,877875,-500,-0.509683995922528
2024-11-22,98500,98800,97100,97800,625998,-700,-0.7106598984771574
2024-11-25,97600,98300,96300,97200,1490846,-400,-0.4098360655737705
2024-11-26,96500,97500,95700,97300,824826,800,0.8290155440414507
2024-11-27,95600,97200,94000,94300,1316143,-1300,-1.3598326359832638
2024-11-28,94400,95800,93900,95000,667018,600,0.6355932203389831
2024-11-29,93200,94500,92100,92900,1137504,-300,-0.3218884120171674
2024-12-02,93900,95800,93500,94200,856300,300,0.3194888178913738
2024-12-03,95900,98000,95000,98000,1269834,2100,2.18978102189781
2024-12-04,96700,99700,96300,98100,1718985,1400,1.4477766287487073
2024-12-05,97200,98400,93800,94000,1047065,-3200,-3.292181069958848
2024-12-06,94100,96200,93200,94800,974415,700,0.7438894792773645
2024-12-09,93200,94400,92000,92000,1163885,-1200,-1.2875536480686696
2024-12-10,93000,96000,93000,95800,1426079,2800,3.010752688172043
2024-12-11,96500,97500,95400,96500,891106,0,0.0
2024-12-12,96800,98900,96800,97200,1672208,400,0.4132231404958678
2024-12-13,97500,98600,96100,98100,784619,600,0.6153846153846154
2024-12-16,98100,98200,95300,95300,977937,-2800,-2.854230377166157
2024-12-17,95400,97200,95400,95700,1015342,300,0.3144654088050315
2024-12-18,96500,102400,96500,101800,2225773,5300,5.492227979274611
2024-12-19,100000,101800,98900,100600,1674120,600,0.6
2024-12-20,100100,101200,99000,101200,1253819,1100,1.098901098901099
2024-12-23,101200,102700,99500,100900,778490,-300,-0.2964426877470355
2024-12-24,100600,101500,99500,100600,588138,0,0.0
2024-12-26,100800,103000,99600,102900,912601,2100,2.083333333333333
2024-12-27,101100,101800,100000,100900,607220,-200,-0.19782393669634024
2024-12-30,100500,103100,100400,100700,704616,200,0.1990049751243781
