Date,Open,High,Low,Close,Volume,Change,ChangeRatio
2024-01-02,202000,202500,199800,200500,373050,-1500,-0.7425742574257426
2024-01-03,199100,199500,193800,193800,548675,-5300,-2.6619789050728278
2024-01-04,192000,192800,189100,190000,505979,-2000,-1.0416666666666665
2024-01-05,190100,190500,187200,187300,440219,-2800,-1.4729089952656496
2024-01-08,187600,188900,185500,185700,323498,-1900,-1.0127931769722816
2024-01-09,187800,187800,185500,185600,349068,-2200,-1.1714589989350372
2024-01-10,185600,187300,185200,186700,330767,1100,0.5926724137931034
2024-01-11,187200,189000,187000,187000,538799,-200,-0.10683760683760685
2024-01-12,186600,187400,185800,186000,240690,-600,-0.3215434083601286
2024-01-15,186000,188600,185800,187500,251099,1500,0.8064516129032258
2024-01-16,186600,188100,185700,186200,225780,-400,-0.21436227224008575
2024-01-17,186300,186400,181000,181800,481127,-4500,-2.4154589371980677
2024-01-18,180000,182500,179900,180200,433597,200,0.1111111111111111
2024-01-19,183000,183000,180100,181700,288166,-1300,-0.7103825136612022
2024-01-22,182300,182400,179800,180100,391914,-2200,-1.206801974766868
2024-01-23,181200,184800,180900,184800,376671,3600,1.9867549668874174
2024-01-24,185300,185400,182100,185000,345726,-300,-0.16189962223421478
2024-01-25,184400,190500,183500,188700,778658,4300,2.331887201735358
2024-01-26,189300,189600,186500,187300,468376,-2000,-1.0565240359218173
2024-01-29,187300,197300,186600,195600,1199045,8300,4.431393486385478
2024-01-30,196000,196600,189300,190000,955999,-6000,-3.061224489795918
2024-01-31,189300,195400,188500,194600,1053355,5300,2.7997886951928157
2024-02-01,193900,209000,193500,208000,2855056,14100,7.271789582258896
2024-02-02,221500,228000,214000,227000,5844398,5500,2.4830699774266365
2024-02-05,233500,239500,226000,238000,5742710,4500,1.9271948608137044
2024-02-06,234000,240000,230500,235500,3293825,1500,0.641025641025641
2024-02-07,239000,246500,238000,245000,2711612,6000,2.510460251046025
2024-02-08,243000,250500,241500,250000,3017429,7000,2.880658436213992
2024-02-13,251000,261000,247500,249000,2690468,-2000,-0.796812749003984
2024-02-14,245000,251000,244500,245500,1702299,500,0.20408163265306123
2024-02-15,250000,250500,237000,240000,2103428,-10000,-4.0
2024-02-16,241500,253000,235500,252500,2261790,11000,4.554865424430641
2024-02-19,253500,257000,248500,252500,1801441,-1000,-0.39447731755424065
2024-02-20,250000,253000,238500,242000,1944653,-8000,-3.2
2024-02-21,242000,246000,237500,239500,1149137,-2500,-1.0330578512396695
2024-02-22,239000,245500,237500,243500,1475580,4500,1.882845188284519
2024-02-23,244000,249500,242000,244000,1660625,0,0.0
2024-02-26,237500,241000,231500,239000,1751340,1500,0.631578947368421
2024-02-27,239000,244500,237500,238500,1265434,-500,-0.20920502092050208
2024-02-28,234000,250000,231500,248000,1911431,14000,5.982905982905983
2024-02-29,246500,253500,243500,250500,2056620,4000,1.6227180527383367
2024-03-04,255500,260000,253000,255500,1854280,0,0.0
2024-03-05,251500,254500,247500,249000,1436614,-2500,-0.9940357852882704
2024-03-06,247000,254000,246000,251000,1103072,4000,1.6194331983805668
2024-03-07,252500,258000,247500,250000,988457,-2500,-0.9900990099009901
2024-03-08,251500,255000,249500,253000,1210240,1500,0.5964214711729622
2024-03-11,251000,252500,242000,243500,1178615,-7500,-2.9880478087649402
2024-03-12,244000,247000,240000,241500,1096802,-2500,-1.0245901639344261
2024-03-13,243500,250000,241000,248500,1413782,5000,2.0533880903490758
2024-03-14,248000,255000,246000,251500,1574794,3500,1.411290322580645
2024-03-15,250000,254500,243500,243500,1175933,-6500,-2.6
2024-03-18,244000,247500,241000,242500,723835,-1500,-0.6147540983606558
2024-03-19,241000,244000,236000,237500,944727,-3500,-1.4522821576763485
2024-03-20,240000,246000,237500,241000,1230314,1000,0.4166666666666667
2024-03-21,247000,254000,246000,252000,1578378,5000,2.0242914979757085
2024-03-22,252500,254000,241000,243500,1091572,-9000,-3.564356435643564
2024-03-25,244000,245500,239500,239500,784822,-4500,-1.8442622950819672
2024-03-26,239000,244000,238500,240500,802094,1500,0.6276150627615062
2024-03-27,241000,247500,240500,244000,818180,3000,1.2448132780082988
2024-03-28,246000,246000,236000,237000,1050347,-9000,-3.6585365853658534
2024-03-29,238000,239000,232000,233000,852346,-5000,-2.100840336134454
2024-04-01,234500,235000,227000,227500,898781,-7000,-2.9850746268656714
2024-04-02,225000,226500,216500,220000,1802613,-5000,-2.2222222222222223
2024-04-03,219000,223500,214500,216000,1138600,-3000,-1.36986301369863
2024-04-04,218500,228500,216500,226000,1357330,7500,3.4324942791762014
2024-04-05,223500,230000,223000,225500,1121453,2000,0.8948545861297539
2024-04-08,227000,238000,226000,232500,1245057,5500,2.4229074889867843
2024-04-09,234500,236500,228000,228000,663665,-6500,-2.771855010660981
2024-04-11,222000,241000,220000,241000,1853791,19000,8.558558558558559
2024-04-12,241000,241500,237000,238000,997710,-3000,-1.2448132780082988
2024-04-15,236000,243000,233500,241500,1018783,5500,2.330508474576271
2024-04-16,239000,244500,236500,242000,1201766,3000,1.2552301255230125
2024-04-17,242000,243000,233500,233500,1029202,-8500,-3.512396694214876
2024-04-18,237000,239000,228500,231000,1168222,-6000,-2.5316455696202533
2024-04-19,231000,237000,229000,235000,1174278,4000,1.7316017316017316
2024-04-22,240000,246000,239500,245000,1314974,5000,2.083333333333333
2024-04-23,250000,251500,246000,249500,1153091,-500,-0.2
2024-04-24,249000,253500,247500,252500,1242059,3500,1.4056224899598393
2024-04-25,251000,254000,246000,250000,1297404,-1000,-0.398406374501992
2024-04-26,250000,253500,243000,249500,980459,-500,-0.2
2024-04-29,249000,254500,245500,251500,852780,2500,1.0040160642570282
2024-04-30,250000,253000,248000,251000,545747,1000,0.4
2024-05-02,249000,251500,246500,249000,602350,0,0.0
2024-05-03,250000,250500,241000,241000,727057,-9000,-3.5999999999999996
2024-05-07,242500,246000,240000,242000,799659,-500,-0.2061855670103093
2024-05-08,240500,244000,240000,242000,444082,1500,0.6237006237006237
2024-05-09,242000,242500,235000,237000,704379,-5000,-2.066115702479339
2024-05-10,239000,243000,237000,241500,455541,2500,1.0460251046025104
2024-05-13,242500,247500,242000,245000,550255,2500,1.0309278350515463
2024-05-14,245500,247000,243000,246500,670650,1000,0.40733197556008144
2024-05-16,248000,248500,245500,247000,559548,-1000,-0.4032258064516129
2024-05-17,247000,249500,244000,244000,408947,-3000,-1.214574898785425
2024-05-20,245500,255000,244500,250500,860566,5000,2.0366598778004072
2024-05-21,249000,254000,248000,253000,576613,4000,1.6064257028112447
2024-05-22,253000,277500,251000,277000,3336634,24000,9.486166007905137
2024-05-23,273500,275000,267500,271500,1886248,-2000,-0.7312614259597806
2024-05-24,268500,274500,266000,267500,1059149,-1000,-0.37243947858473
2024-05-27,267500,271500,262000,265500,1011436,-2000,-0.7476635514018692
2024-05-28,265000,270000,263500,265000,598743,0,0.0
2024-05-29,262500,265000,257000,261000,965532,-1500,-0.5714285714285714
2024-05-30,260500,264000,255500,257000,640526,-3500,-1.3435700575815739
2024-05-31,259500,260000,253000,253000,1014549,-6500,-2.5048169556840074
2024-06-03,257500,270000,257000,265000,1186533,7500,2.912621359223301
2024-06-04,262500,265500,258000,259000,660409,-3500,-1.3333333333333335
2024-06-05,261000,267500,256500,264000,882084,3000,1.1494252873563218
2024-06-07,262500,266500,261500,265000,519878,2500,0.9523809523809524
2024-06-10,261500,271500,261000,267500,945927,6000,2.294455066921606
2024-06-11,270500,273500,267500,271000,967240,500,0.18484288354898337
2024-06-12,273000,273000,268000,270000,567334,-3000,-1.098901098901099
2024-06-13,273000,281000,269000,269000,1862106,-4000,-1.465201465201465
2024-06-14,268500,274000,267000,268000,778015,-500,-0.186219739292365
2024-06-17,276000,285000,275500,278500,1945849,2500,0.9057971014492754
2024-06-18,280500,290000,278500,283000,1667920,2500,0.8912655971479502
2024-06-19,286500,292500,284000,286500,1228960,0,0.0
2024-06-20,285500,288000,282500,285500,629996,0,0.0
2024-06-21,283500,285000,279000,280000,876560,-3500,-1.2345679012345678
2024-06-24,277000,283000,275500,281000,598019,4000,1.444043321299639
2024-06-25,281000,292500,280000,288500,1023261,7500,2.6690391459074734
2024-06-26,289000,293500,286500,289500,694207,500,0.17301038062283738
2024-06-27,287000,298500,286500,298000,1157313,11000,3.8327526132404177
2024-06-28,299500,299500,293000,295000,761453,-4500,-1.5025041736227045
2024-07-01,292000,296000,285500,286000,864443,-6000,-2.054794520547945
2024-07-02,283000,283500,271000,272500,1558999,-10500,-3.7102473498233217
2024-07-03,275000,281500,272500,276000,1072157,1000,0.36363636363636365
2024-07-04,277500,281000,274500,277500,552767,0,0.0
2024-07-05,277500,282000,277000,281000,586121,3500,1.2612612612612613
2024-07-08,282000,289500,281000,283000,603805,1000,0.3546099290780142
2024-07-09,284000,285500,272500,274500,1135540,-9500,-3.345070422535211
2024-07-10,275000,277500,272500,274500,672155,-500,-0.18181818181818182
2024-07-11,277000,278500,274500,278500,653458,1500,0.5415162454873645
2024-07-12,277500,278500,268000,271500,666813,-6000,-2.1621621621621623
2024-07-15,273000,273500,267500,268500,541442,-4500,-1.6483516483516485
2024-07-16,270500,276000,270000,274500,552065,4000,1.478743068391867
2024-07-17,275500,275500,268000,268500,512968,-7000,-2.540834845735027
2024-07-18,267000,267500,256500,260500,1083373,-6500,-2.4344569288389515
2024-07-19,258500,259500,254000,258500,737904,0,0.0
2024-07-22,259000,261500,251000,255000,769457,-4000,-1.5444015444015444
2024-07-23,258000,264500,257500,263500,803042,5500,2.131782945736434
2024-07-24,259500,263500,257500,258500,608412,-1000,-0.3853564547206166
2024-07-25,253000,255000,247500,251500,832753,-1500,-0.592885375494071
2024-07-26,248500,250500,232000,243500,2662741,-5000,-2.0120724346076457
2024-07-29,244000,260000,243000,255500,1302271,11500,4.713114754098361
2024-07-30,253000,258000,249500,250000,594899,-3000,-1.185770750988142
2024-07-31,250000,253500,247500,249000,594919,-1000,-0.4
2024-08-01,251000,258500,251000,253500,734315,2500,0.9960159362549801
2024-08-02,242500,248000,242000,244000,889521,1500,0.6185567010309279
2024-08-05,236000,239500,216500,224000,1465965,-12000,-5.084745762711865
2024-08-06,233500,241500,228000,235000,1250180,1500,0.6423982869379015
2024-08-07,233000,241000,231500,236000,756779,3000,1.2875536480686696
2024-08-08,231500,240000,228500,236500,698685,5000,2.159827213822894
2024-08-09,240500,248000,240000,243000,606967,2500,1.0395010395010396
2024-08-12,246000,249000,242000,243500,469844,-2500,-1.0162601626016259
2024-08-13,242000,245500,240000,243000,358474,1000,0.4132231404958678
2024-08-14,245500,248000,238500,241000,500276,-4500,-1.8329938900203666
2024-08-16,248000,256500,246500,255000,1113073,7000,2.82258064516129
2024-08-19,256000,259500,250000,255000,739313,-1000,-0.390625
2024-08-20,258000,261000,255000,256000,660818,-2000,-0.7751937984496124
2024-08-21,257500,257500,251000,252500,359513,-5000,-1.9417475728155338
2024-08-22,253500,254000,245500,248000,497250,-5500,-2.1696252465483234
2024-08-23,245500,254000,245000,252500,449189,7000,2.8513238289205702
2024-08-26,255500,258000,247500,249500,469538,-6000,-2.3483365949119372
2024-08-27,248500,251000,244500,247500,555018,-1000,-0.4024144869215292
2024-08-28,249500,261000,246000,259000,1170970,9500,3.807615230460922
2024-08-29,261500,267000,256000,258500,1646679,-3000,-1.147227533460803
2024-08-30,261000,265500,255500,255500,1206940,-5500,-2.10727969348659
2024-09-02,256000,256000,245000,246000,1006660,-10000,-3.90625
2024-09-03,244000,244500,236000,237500,1024521,-6500,-2.663934426229508
2024-09-04,231000,236500,229500,232500,942257,1500,0.6493506493506493
2024-09-05,236000,237500,227000,229000,884047,-7000,-2.9661016949152543
2024-09-06,228000,230500,223000,227500,710077,-500,-0.21929824561403508
2024-09-09,225500,231500,225000,229500,638085,4000,1.7738359201773837
2024-09-10,229500,231000,227000,231000,364974,1500,0.6535947712418301
2024-09-11,229500,230500,221500,223500,781938,-6000,-2.6143790849673203
2024-09-12,226000,232000,225500,232000,660069,6000,2.6548672566371683
2024-09-13,237500,240500,234500,237000,524969,-500,-0.21052631578947367
2024-09-19,244000,246500,241500,246000,848380,2000,0.819672131147541
2024-09-20,250000,251000,247500,250500,809348,500,0.2
2024-09-23,251500,251500,246500,249000,484728,-2500,-0.9940357852882704
2024-09-24,249000,253000,248000,253000,429463,4000,1.6064257028112447
2024-09-25,255500,257000,250500,251500,575575,-4000,-1.5655577299412915
2024-09-26,250000,259000,247500,259000,766978,9000,3.5999999999999996
2024-09-27,257500,259000,253500,254500,493853,-3000,-1.1650485436893203
2024-09-30,255500,256000,244000,244000,1032595,-11500,-4.500978473581213
2024-10-02,237500,241000,236500,237000,1035510,-500,-0.21052631578947367
2024-10-04,235500,241500,232000,239500,856583,4000,1.6985138004246285
2024-10-07,244000,247000,241000,247000,731171,3000,1.2295081967213115
2024-10-08,244500,247000,244000,246000,413552,1500,0.6134969325153374
2024-10-10,253000,255500,246000,246000,641891,-7000,-2.766798418972332
2024-10-11,248000,249500,246500,248500,282919,500,0.20161290322580644
2024-10-14,250500,254000,248000,248500,307668,-2000,-0.7984031936127743
2024-10-15,249500,249500,246000,246000,382087,-3500,-1.402805611222445
2024-10-16,246000,247000,242000,247000,799813,1000,0.40650406504065045
2024-10-17,245000,246000,235500,235500,923060,-9500,-3.877551020408163
2024-10-18,237000,239000,233000,234500,696368,-2500,-1.0548523206751055
2024-10-21,235000,240000,234500,237000,443742,2000,0.851063829787234
2024-10-22,236000,239000,232500,234500,517834,-1500,-0.6355932203389831
2024-10-23,236500,243000,234000,241000,671384,4500,1.9027484143763214
2024-10-24,241000,241000,228000,228500,1209781,-12500,-5.186721991701245
2024-10-25,226500,231000,220500,225500,1116832,-1000,-0.44150110375275936
2024-10-28,226000,229000,224000,226500,639039,500,0.22123893805309736
2024-10-29,226000,226500,221000,224000,746178,-2000,-0.8849557522123894
2024-10-30,223000,225000,220500,220500,554300,-2500,-1.1210762331838564
2024-10-31,220500,221500,215000,215000,1075398,-5500,-2.494331065759637
2024-11-01,212500,216500,211500,213500,765177,1000,0.4705882352941176
2024-11-04,215000,220500,214000,216500,748180,1500,0.6976744186046512
2024-11-05,214000,215500,211500,215000,615978,1000,0.46728971962616817
2024-11-06,214000,214500,205500,206500,1880618,-7500,-3.5046728971962615
2024-11-07,203500,210500,201000,207500,1108161,4000,1.9656019656019657
2024-11-08,209500,210500,202500,203500,716859,-6000,-2.863961813842482
2024-11-11,203500,212500,203500,211000,856539,7500,3.6855036855036856
2024-11-12,213000,213500,206500,207000,911213,-6000,-2.8169014084507045
2024-11-13,206000,206000,199900,199900,778547,-6100,-2.9611650485436893
2024-11-14,200500,203500,197300,201500,817142,1000,0.4987531172069825
2024-11-15,200000,208500,199900,206000,709396,6000,3.0
2024-11-18,206000,218000,206000,217000,1115993,11000,5.339805825242718
2024-11-19,217000,219000,213000,215500,540792,-1500,-0.6912442396313364
2024-11-20,213000,220500,212500,218500,572617,5500,2.5821596244131455
2024-11-21,218500,219500,215500,215500,499737,-3000,-1.3729977116704806
2024-11-22,216000,218500,214500,217000,419056,1000,0.4629629629629629
2024-11-25,219000,221500,216500,219000,726301,0,0.0
2024-11-26,218000,224500,216500,223500,721544,5500,2.522935779816514
2024-11-27,220000,226500,218500,221000,1094533,1000,0.45454545454545453
2024-11-28,224000,225000,218000,219000,593477,-5000,-2.232142857142857
2024-11-29,219000,220000,214500,218500,576357,-500,-0.228310502283105
2024-12-02,219500,220500,215000,216000,520654,-3500,-1.5945330296127564
2024-12-03,218000,218000,213500,214500,624929,-3500,-1.6055045871559634
2024-12-04,208500,213000,207000,209000,919137,500,0.2398081534772182
2024-12-05,209000,210500,204000,204500,604002,-4500,-2.15311004784689
2024-12-06,203500,206000,200000,203500,778285,0,0.0
2024-12-09,201000,203000,200000,201000,774548,0,0.0
2024-12-10,205500,211500,204000,210500,619392,5000,2.4330900243309004
2024-12-11,208000,211000,207500,209000,335301,1000,0.4807692307692308
2024-12-12,210500,213000,209500,211500,625351,1000,0.4750593824228029
2024-12-13,212000,216000,209000,215000,528172,3000,1.4150943396226416
2024-12-16,215500,216000,210500,211000,469448,-4500,-2.088167053364269
2024-12-17,210000,212500,205500,206500,715553,-3500,-1.6666666666666667
2024-12-18,207500,217000,207500,216500,712305,9000,4.337349397590361
2024-12-19,213000,214000,210500,212000,631880,-1000,-0.4694835680751174
2024-12-20,210500,211500,206000,210500,704962,0,0.0
2024-12-23,212500,216500,212000,215000,468339,2500,1.1764705882352942
2024-12-24,215000,217000,213000,216500,351647,1500,0.6976744186046512
2024-12-26,217500,219500,215000,217500,460871,0,0.0
2024-12-27,217000,217500,213500,215000,391681,-2000,-0.9216589861751152
2024-12-30,213500,217000,212000,212000,387750,-1500,-0.702576112412178
