Date,Open,High,Low,Close,Volume,Change,ChangeRatio
2024-01-02,425000,429500,422000,429500,152929,4500,1.0588235294117647
2024-01-03,425500,426000,416000,416000,196510,-9500,-2.2326674500587544
2024-01-04,414000,419000,410000,419000,131106,5000,1.2077294685990339
2024-01-05,416500,420500,414500,416000,138131,-500,-0.12004801920768307
2024-01-08,419500,419500,414500,415000,112716,-4500,-1.0727056019070322
2024-01-09,419500,419500,415000,417500,141094,-2000,-0.47675804529201427
2024-01-10,417500,417500,405500,410500,195832,-7000,-1.6766467065868262
2024-01-11,409500,420000,409500,415500,234974,6000,1.465201465201465
2024-01-12,415000,415500,409000,413000,151154,-2000,-0.48192771084337355
2024-01-15,409000,409500,397000,399500,283565,-9500,-2.3227383863080684
2024-01-16,396500,404000,394500,400500,246497,4000,1.008827238335435
2024-01-17,400000,400500,387000,390000,263868,-10000,-2.5
2024-01-18,390000,399000,387000,390500,190739,500,0.1282051282051282
2024-01-19,390500,397000,378500,383500,263399,-7000,-1.792573623559539
2024-01-22,383500,387000,371500,372000,214410,-11500,-2.9986962190352022
2024-01-23,370500,379000,370500,373500,170955,3000,0.8097165991902834
2024-01-24,372500,385000,370500,380500,218985,8000,2.1476510067114094
2024-01-25,375000,375500,363000,368000,317036,-7000,-1.866666666666667
2024-01-26,364000,392000,362000,381000,331129,17000,4.670329670329671
2024-01-29,385000,387000,377500,377500,216167,-7500,-1.948051948051948
2024-01-30,382500,387500,373000,375000,222999,-7500,-1.9607843137254901
2024-01-31,379000,387500,377000,381000,212973,2000,0.5277044854881267
2024-02-01,378000,383000,373000,381500,232165,3500,0.9259259259259258
2024-02-02,384500,392500,381500,387500,261741,3000,0.7802340702210664
2024-02-05,389000,393000,385500,389000,210367,0,0.0
2024-02-06,385000,387500,376000,377000,196337,-8000,-2.0779220779220777
2024-02-07,382000,394000,382000,386000,244380,4000,1.0471204188481675
2024-02-08,397500,397500,386500,394000,314399,-3500,-0.8805031446540881
2024-02-13,395000,395500,390000,393500,178139,-1500,-0.37974683544303794
2024-02-14,390000,390000,380000,388000,184384,-2000,-0.5128205128205128
2024-02-15,393500,397500,389000,395500,192353,2000,0.5082592121982211
2024-02-16,401500,412000,401000,410000,354959,8500,2.1170610211706102
2024-02-19,412000,412500,395500,397500,289496,-14500,-3.5194174757281553
2024-02-20,397500,404500,392000,404000,157923,6500,1.6352201257861636
2024-02-21,402500,408000,398000,407000,153418,4500,1.1180124223602486
2024-02-22,410000,415500,405000,408500,177713,-1500,-0.3658536585365854
2024-02-23,411500,411500,402000,402000,146754,-9500,-2.3086269744835968
2024-02-26,402500,414000,402000,409500,142484,7000,1.7391304347826086
2024-02-27,413500,417000,400500,403500,138018,-10000,-2.418379685610641
2024-02-28,403500,408500,399500,400500,133998,-3000,-0.7434944237918215
2024-02-29,399000,407000,394000,401500,355999,2500,0.6265664160401002
2024-03-04,401000,406000,398500,398500,170895,-2500,-0.6234413965087282
2024-03-05,396000,398500,387000,387500,240864,-8500,-2.146464646464646
2024-03-06,386500,391000,386000,387000,118343,500,0.129366106080207
2024-03-07,391000,402000,387500,399500,199901,8500,2.1739130434782608
2024-03-08,403500,406500,399500,402500,162446,-1000,-0.24783147459727387
2024-03-11,402500,407000,399000,400500,104044,-2000,-0.4968944099378882
2024-03-12,404500,420000,404500,419500,381220,15000,3.7082818294190356
2024-03-13,419500,422000,415000,418500,212299,-1000,-0.23837902264600713
2024-03-14,416500,417000,405000,416000,306911,-500,-0.12004801920768307
2024-03-15,407000,410000,398500,398500,247909,-8500,-2.0884520884520885
2024-03-18,402000,408500,401000,407500,134399,5500,1.3681592039800996
2024-03-19,412000,412000,402000,403000,118968,-9000,-2.1844660194174756
2024-03-20,405000,410000,404000,407500,114805,2500,0.6172839506172839
2024-03-21,409500,414000,409000,413500,154423,4000,0.9768009768009768
2024-03-22,410500,415500,409000,413500,136480,3000,0.730816077953715
2024-03-25,416500,417000,412000,414500,162037,-2000,-0.4801920768307323
2024-03-26,417000,417500,405500,406000,198659,-11000,-2.6378896882494005
2024-03-27,406000,412500,404500,409000,138182,3000,0.7389162561576355
2024-03-28,410000,411000,401000,401500,183993,-8500,-2.073170731707317
2024-03-29,401500,402500,393000,395000,200531,-6500,-1.61892901618929
2024-04-01,395000,398500,392500,395500,105333,500,0.12658227848101267
2024-04-02,395500,400000,392500,393000,163860,-2500,-0.6321112515802781
2024-04-03,391500,391500,376000,376000,365852,-15500,-3.959131545338442
2024-04-04,379500,384000,376000,379500,175633,0,0.0
2024-04-05,375500,380000,373000,376000,152154,500,0.13315579227696406
2024-04-08,374000,375500,358000,373000,307183,-1000,-0.267379679144385
2024-04-09,376500,382500,372500,374000,180102,-2500,-0.6640106241699867
2024-04-11,368500,380000,365000,380000,341170,11500,3.1207598371777476
2024-04-12,380000,381500,371500,371500,172629,-8500,-2.236842105263158
2024-04-15,367000,377000,365500,373000,106708,6000,1.6348773841961852
2024-04-16,368000,372500,366000,366000,119203,-2000,-0.5434782608695652
2024-04-17,366000,372000,364000,364500,99287,-1500,-0.4098360655737705
2024-04-18,364000,378500,364000,377000,156443,13000,3.571428571428571
2024-04-19,372000,372000,364500,367000,143664,-5000,-1.3440860215053763
2024-04-22,373000,378500,369000,378500,144221,5500,1.4745308310991956
2024-04-23,377000,379000,370000,370000,121904,-7000,-1.8567639257294428
2024-04-24,380500,389500,378000,385000,241390,4500,1.1826544021024967
2024-04-25,380000,381000,372000,372500,176196,-7500,-1.9736842105263157
2024-04-26,373000,375000,367500,372000,143701,-1000,-0.2680965147453083
2024-04-29,375000,378500,372000,378500,150391,3500,0.9333333333333335
2024-04-30,382500,390000,382500,389000,276918,6500,1.6993464052287581
2024-05-02,385000,392000,381000,389000,121266,4000,1.0389610389610389
2024-05-03,391000,394000,387000,391000,121565,0,0.0
2024-05-07,394500,397000,390500,391500,117367,-3000,-0.7604562737642585
2024-05-08,391000,395000,387500,393000,144291,2000,0.5115089514066496
2024-05-09,390000,393000,383000,388500,239286,-1500,-0.38461538461538464
2024-05-10,390500,390500,383500,383500,115093,-7000,-1.792573623559539
2024-05-13,384000,384500,379000,381500,125868,-2500,-0.6510416666666667
2024-05-14,382500,388000,382500,385500,119763,3000,0.7843137254901961
2024-05-16,389000,390000,381500,381500,140797,-7500,-1.9280205655526992
2024-05-17,381500,384000,376000,376500,175717,-5000,-1.310615989515072
2024-05-20,379000,379500,370000,372000,159484,-7000,-1.8469656992084433
2024-05-21,367500,370000,364000,364500,224181,-3000,-0.8163265306122449
2024-05-22,366500,369500,364000,364000,130152,-2500,-0.6821282401091405
2024-05-23,364000,366000,360000,362000,157841,-2000,-0.5494505494505495
2024-05-24,358500,359000,355500,356000,213011,-2500,-0.697350069735007
2024-05-27,357000,366000,355500,364500,157232,7500,2.100840336134454
2024-05-28,363500,363500,359000,360000,136480,-3500,-0.9628610729023385
2024-05-29,356500,361000,342000,342000,386788,-14500,-4.067321178120617
2024-05-30,342000,343500,326000,328000,401661,-14000,-4.093567251461988
2024-05-31,331500,335500,328000,331000,264516,-500,-0.1508295625942685
2024-06-03,330500,341000,329500,332000,194056,1500,0.45385779122541603
2024-06-04,329500,340000,329000,336500,146087,7000,2.12443095599393
2024-06-05,339000,359500,338000,351500,395864,12500,3.687315634218289
2024-06-07,355000,360000,352500,359000,208870,4000,1.1267605633802817
2024-06-10,355500,358500,350000,353000,180618,-2500,-0.7032348804500703
2024-06-11,354000,365000,353000,356500,219013,2500,0.7062146892655368
2024-06-12,356500,361000,350500,351500,163853,-5000,-1.402524544179523
2024-06-13,356000,363000,349000,363000,412793,7000,1.9662921348314606
2024-06-14,363000,363000,349000,349000,302758,-14000,-3.8567493112947657
2024-06-17,345000,346000,336500,336500,273382,-8500,-2.4637681159420293
2024-06-18,340000,343500,331000,331000,213956,-9000,-2.6470588235294117
2024-06-19,332500,344500,332000,343000,220974,10500,3.1578947368421053
2024-06-20,343000,346000,340000,340000,105297,-3000,-0.8746355685131195
2024-06-21,338000,343000,333000,333000,165513,-5000,-1.4792899408284024
2024-06-24,334000,336000,330500,331000,102798,-3000,-0.8982035928143712
2024-06-25,334000,336000,331000,331000,124542,-3000,-0.8982035928143712
2024-06-26,330500,338000,330000,331000,113087,500,0.15128593040847202
2024-06-27,331500,334000,327500,328000,122751,-3500,-1.0558069381598794
2024-06-28,327000,331500,322500,326500,152685,-500,-0.1529051987767584
2024-07-01,328000,348500,325500,347000,305328,19000,5.7926829268292686
2024-07-02,353000,362000,341500,343500,352020,-9500,-2.6912181303116145
2024-07-03,360000,369500,353000,358000,714015,-2000,-0.5555555555555556
2024-07-04,364000,367000,355500,359000,226816,-5000,-1.3736263736263736
2024-07-05,359000,361500,352000,357500,207422,-1500,-0.4178272980501393
2024-07-08,358000,364000,352500,358500,229191,500,0.13966480446927373
2024-07-09,359000,370000,358000,363000,273777,4000,1.1142061281337048
2024-07-10,363000,367000,360500,362000,172607,-1000,-0.27548209366391185
2024-07-11,364500,375000,357500,375000,516468,10500,2.880658436213992
2024-07-12,371000,375000,368500,373000,182104,2000,0.5390835579514826
2024-07-15,373000,373500,357500,358500,245160,-14500,-3.8873994638069704
2024-07-16,359000,360000,343000,346500,345755,-12500,-3.4818941504178276
2024-07-17,346000,348000,335500,336500,262255,-9500,-2.745664739884393
2024-07-18,333000,342500,331500,335000,197622,2000,0.6006006006006006
2024-07-19,335000,347500,335000,345500,237970,10500,3.134328358208955
2024-07-22,343000,343000,328000,328500,268882,-14500,-4.227405247813411
2024-07-23,330500,333500,324000,326000,152694,-4500,-1.361573373676248
2024-07-24,324000,330000,320000,321500,158027,-2500,-0.7716049382716049
2024-07-25,315000,342500,313000,332500,464700,17500,5.555555555555555
2024-07-26,332000,334000,322500,325000,165067,-7000,-2.108433734939759
2024-07-29,323500,333000,321500,329500,95268,6000,1.8547140649149922
2024-07-30,326000,342000,326000,333000,164442,7000,2.147239263803681
2024-07-31,334000,335000,323000,324000,181873,-10000,-2.9940119760479043
2024-08-01,325000,337000,322000,333500,219837,8500,2.6153846153846154
2024-08-02,326000,337500,324000,336000,200803,10000,3.067484662576687
2024-08-05,332500,340000,311000,322000,408563,-10500,-3.1578947368421053
2024-08-06,331500,342000,328000,337000,370935,5500,1.6591251885369533
2024-08-07,332500,338500,322500,324500,290231,-8000,-2.4060150375939853
2024-08-08,324500,325500,311000,321000,425356,-3500,-1.078582434514638
2024-08-09,323000,329000,317000,322000,260609,-1000,-0.30959752321981426
2024-08-12,321000,330000,321000,328500,144514,7500,2.336448598130841
2024-08-13,325500,331500,322000,329500,127711,4000,1.228878648233487
2024-08-14,334000,342000,332000,337000,196856,3000,0.8982035928143712
2024-08-16,343500,344500,335500,336500,151534,-7000,-2.037845705967977
2024-08-19,336500,336500,328000,329500,126345,-7000,-2.080237741456166
2024-08-20,333000,334000,327000,330000,104179,-3000,-0.9009009009009009
2024-08-21,333000,353000,332000,350000,489967,17000,5.105105105105105
2024-08-22,351500,364000,348500,363000,474976,11500,3.2716927453769555
2024-08-23,359500,366000,357000,359000,232206,-500,-0.13908205841446453
2024-08-26,365500,378000,361500,378000,512014,12500,3.4199726402188784
2024-08-27,378500,383000,371500,376500,341089,-2000,-0.5284015852047557
2024-08-28,375000,379000,366500,368500,259901,-6500,-1.7333333333333332
2024-08-29,371000,394000,370000,391000,725018,20000,5.3908355795148255
2024-08-30,391000,391500,381500,388000,316463,-3000,-0.7672634271099744
2024-09-02,392000,416500,392000,412000,792620,20000,5.1020408163265305
2024-09-03,416500,419000,407000,411000,340713,-5500,-1.3205282112845138
2024-09-04,399000,410000,396500,399500,373803,500,0.12531328320802004
2024-09-05,410500,418000,401000,410000,463032,-500,-0.12180267965895249
2024-09-06,412000,412500,392500,395000,419682,-17000,-4.12621359223301
2024-09-09,388500,404000,386000,399500,302125,11000,2.8314028314028317
2024-09-10,398500,400000,378000,379500,421418,-19000,-4.767879548306149
2024-09-11,380500,402500,380500,399000,365687,18500,4.862023653088042
2024-09-12,403500,414000,395000,414000,361481,10500,2.6022304832713754
2024-09-13,413500,414000,399500,399500,302530,-14000,-3.3857315598548974
2024-09-19,405000,409500,391000,391500,303860,-13500,-3.3333333333333335
2024-09-20,398500,407000,392500,393500,468352,-5000,-1.2547051442910917
2024-09-23,397000,402500,390500,397000,233849,0,0.0
2024-09-24,401000,413000,401000,413000,447420,12000,2.9925187032418954
2024-09-25,415000,420000,409000,413500,349449,-1500,-0.3614457831325301
2024-09-26,410500,415500,402500,413500,304509,3000,0.730816077953715
2024-09-27,413000,418000,406500,414500,250953,1500,0.36319612590799033
2024-09-30,419500,430000,414500,414500,445787,-5000,-1.1918951132300357
2024-10-02,409500,421500,408500,408500,245424,-1000,-0.2442002442002442
2024-10-04,403500,406000,396000,403500,255155,0,0.0
2024-10-07,413500,426000,409000,420000,433698,6500,1.5719467956469164
2024-10-08,416500,444000,412000,436500,803706,20000,4.8019207683073235
2024-10-10,432000,433000,421000,427000,635669,-5000,-1.1574074074074074
2024-10-11,426500,428500,408500,411000,441897,-15500,-3.6342321219226257
2024-10-14,407500,413500,402500,406000,245480,-1500,-0.36809815950920244
2024-10-15,407500,409000,389500,403500,631127,-4000,-0.98159509202454
2024-10-16,415000,415000,404500,404500,495248,-10500,-2.5301204819277108
2024-10-17,403000,411000,397000,397000,250437,-6000,-1.488833746898263
2024-10-18,396500,399000,385000,388500,250780,-8000,-2.01765447667087
2024-10-21,389000,393500,387500,389500,135508,500,0.12853470437017994
2024-10-22,386500,388000,376500,381500,213207,-5000,-1.29366106080207
2024-10-23,381500,405500,381500,403000,332684,21500,5.6356487549148095
2024-10-24,411000,419000,403000,406500,405512,-4500,-1.094890510948905
2024-10-25,419000,419000,406500,407000,242245,-12000,-2.863961813842482
2024-10-28,403000,417500,403000,416500,360352,13500,3.3498759305210917
2024-10-29,410000,412500,400500,409000,281126,-1000,-0.24390243902439024
2024-10-30,406500,417500,405000,411500,174514,5000,1.2300123001230012
2024-10-31,408000,417000,404500,407500,266013,-500,-0.12254901960784313
2024-11-01,405000,419000,404500,412500,254445,7500,1.8518518518518516
2024-11-04,417000,427000,408000,426000,418485,9000,2.158273381294964
2024-11-05,422000,425500,416500,420000,177179,-2000,-0.47393364928909953
2024-11-06,426500,429000,386000,390500,689223,-36000,-8.440797186400937
2024-11-07,389000,391000,375000,386000,456391,-3000,-0.7712082262210797
2024-11-08,394500,408500,394000,398500,379413,4000,1.0139416983523446
2024-11-11,435000,435500,415000,416000,969362,-19000,-4.3678160919540225
2024-11-12,418000,433500,416000,427000,642992,9000,2.15311004784689
2024-11-13,421500,425000,411500,412000,349926,-9500,-2.2538552787663106
2024-11-14,421500,423000,405000,422000,461180,500,0.11862396204033215
2024-11-15,403000,403500,371000,371000,1016392,-32000,-7.94044665012407
2024-11-18,375000,385500,375000,383500,365846,8500,2.2666666666666666
2024-11-19,384500,395500,380500,393500,292704,9000,2.340702210663199
2024-11-20,393500,402500,390000,400500,216309,7000,1.7789072426937738
2024-11-21,399000,406500,394500,400500,209853,1500,0.37593984962406013
2024-11-22,403500,409500,402000,405000,142194,1500,0.37174721189591076
2024-11-25,410000,425000,408000,419500,446632,9500,2.317073170731707
2024-11-26,417000,422000,405000,406000,215592,-11000,-2.6378896882494005
2024-11-27,408500,414000,399500,400500,174304,-8000,-1.9583843329253363
2024-11-28,400000,405500,399000,402500,116484,2500,0.625
2024-11-29,400000,402500,380000,381500,280997,-18500,-4.625
2024-12-02,387000,397500,385000,391500,185989,4500,1.1627906976744187
2024-12-03,393500,401000,385000,397000,241946,3500,0.8894536213468869
2024-12-04,391000,395000,384500,389000,246025,-2000,-0.5115089514066496
2024-12-05,389000,395000,382000,382000,170616,-7000,-1.7994858611825193
2024-12-06,383000,397000,383000,390500,265117,7500,1.95822454308094
2024-12-09,385500,397500,379500,387500,254353,2000,0.5188067444876783
2024-12-10,392000,396000,384500,385000,249658,-7000,-1.7857142857142856
2024-12-11,388000,391000,376500,378000,260700,-10000,-2.5773195876288657
2024-12-12,383000,404500,374000,404500,586555,21500,5.613577023498695
2024-12-13,396000,400000,389500,400000,330114,4000,1.0101010101010102
2024-12-16,399000,402500,394500,398000,204346,-1000,-0.2506265664160401
2024-12-17,398500,405000,378500,382500,392455,-16000,-4.0150564617314926
2024-12-18,384000,386000,380000,381500,208785,-2500,-0.6510416666666667
2024-12-19,373500,380000,368000,372000,247458,-1500,-0.4016064257028112
2024-12-20,375000,377000,356000,357500,359300,-17500,-4.666666666666667
2024-12-23,359000,361500,345000,359000,284110,0,0.0
2024-12-24,361500,362000,350000,350000,172107,-11500,-3.18118948824343
2024-12-26,351500,352000,343500,344500,174814,-7000,-1.991465149359886
2024-12-27,341000,350500,340500,348000,200696,7000,2.0527859237536656
2024-12-30,345000,358500,345000,348000,169683,3000,0.8695652173913043
