Date,Open,High,Low,Close,Volume,Change,ChangeRatio
2024-01-02,194360,230176,194360,221103,6266598,26743,13.759518419427867
2024-01-03,218237,222535,213939,221103,1985634,2866,1.313251190219807
2024-01-04,218237,218714,204866,208209,1667980,-10028,-4.595004513441809
2024-01-05,205344,210597,203434,204867,1015753,-477,-0.2322931276297335
2024-01-08,203433,206298,195315,196748,944191,-6685,-3.2860941931741654
2024-01-09,201523,204388,194837,196748,647042,-4775,-2.3694565880817575
2024-01-10,196748,200568,195792,196748,428724,0,0.0
2024-01-11,197703,199613,188820,195793,1387463,-1910,-0.9660956080585524
2024-01-12,189298,196270,185860,188057,1810995,-1241,-0.6555800906507201
2024-01-15,187674,190062,177932,179652,1490338,-8022,-4.27443332587359
2024-01-16,183758,185573,177646,179079,1218136,-4679,-2.5462836992130957
2024-01-17,178219,178315,169146,170006,1340398,-8213,-4.6083750890758
2024-01-18,170005,171438,165898,166854,845735,-3151,-1.8534748977971236
2024-01-19,168000,172775,167045,168096,838846,96,0.05714285714285715
2024-01-22,170005,177932,169814,175354,1110603,5349,3.14637804770448
2024-01-23,177741,180034,172679,173444,682359,-4297,-2.4175626332697577
2024-01-24,174686,174877,172393,172585,310250,-2101,-1.2027294688755825
2024-01-25,172297,175640,170960,173826,490537,1529,0.8874211390796125
2024-01-26,172679,175927,171151,174017,403507,1338,0.7748481286085742
2024-01-29,175736,179079,173540,173540,788306,-2196,-1.2496016752401329
2024-01-30,175831,176786,171534,171534,460274,-4297,-2.443823899084917
2024-01-31,171533,172966,168190,171629,477754,96,0.05596590743472101
2024-02-01,169718,171724,165898,170674,655492,956,0.5632873354623552
2024-02-02,170674,175736,170674,175736,569307,5062,2.9658881844920724
2024-02-05,175736,176118,171438,172776,536543,-2960,-1.6843446988664814
2024-02-06,173061,177837,173061,174781,600929,1720,0.9938692137454423
2024-02-07,175831,177169,170674,170961,785152,-4870,-2.7697050008246555
2024-02-08,171534,174208,171151,171534,673874,0,0.0
2024-02-13,173443,179843,173252,179079,977031,5636,3.249482538932099
2024-02-14,176500,177646,174494,175927,505762,-573,-0.3246458923512748
2024-02-15,177741,177741,174399,174399,375757,-3342,-1.880263979610782
2024-02-16,176118,176213,173825,174017,309106,-2101,-1.1929501811285614
2024-02-19,174016,175545,173443,174208,308436,192,0.11033468186833395
2024-02-20,174303,174780,171628,171820,461131,-2483,-1.424530845711204
2024-02-21,171820,171916,168955,169051,576134,-2769,-1.6115702479338843
2024-02-22,169623,171533,167522,168573,538917,-1050,-0.619019826320723
2024-02-23,169241,176118,168859,171916,863203,2675,1.5805862645576425
2024-02-26,173826,174972,172680,173349,507720,-477,-0.27441234337786063
2024-02-27,173825,182803,173157,181562,1701105,7737,4.451028333093628
2024-02-28,181658,184714,178124,181467,854519,-191,-0.10514263065760936
2024-02-29,181084,182708,171629,171629,1416886,-9455,-5.221333745664995
2024-03-04,172297,173157,167235,168191,959707,-4106,-2.3830943080842966
2024-03-05,167140,171916,164562,167905,1034938,765,0.4577001316261816
2024-03-06,168095,172775,166662,172489,690677,4394,2.6139980368244147
2024-03-07,173252,174876,168763,169146,565293,-4106,-2.3699582111606214
2024-03-08,171724,173157,169909,172202,543822,478,0.27835363723183715
2024-03-11,173061,174398,171246,171438,398608,-1623,-0.9378196127377052
2024-03-12,172202,173826,168095,173540,442442,1338,0.7769944599946574
2024-03-13,173635,173826,169719,170770,479527,-2865,-1.6500129582169492
2024-03-14,170674,172393,170578,171343,1919837,669,0.3919753448094027
2024-03-15,172106,174112,170769,172680,1095581,574,0.3335153916772222
2024-03-18,172775,176118,172202,174304,560098,1529,0.8849659962378816
2024-03-19,172870,176500,172393,176118,643300,3248,1.8788685139121883
2024-03-20,176978,177169,174781,174877,391630,-2101,-1.1871532054831675
2024-03-21,176690,177455,174971,177455,623630,765,0.43296168430584636
2024-03-22,177264,180416,177169,179748,598151,2484,1.4012997562956946
2024-03-25,181657,183758,180416,180416,676431,-1241,-0.6831556174548737
2024-03-26,180321,182899,177169,178029,722861,-2292,-1.271066597900411
2024-03-27,176213,177646,172202,175927,674622,-286,-0.16230357578612248
2024-03-28,174303,177932,173825,175545,939101,1242,0.7125522796509526
2024-03-29,175736,184141,175736,182613,1499864,6877,3.913256248008376
2024-04-01,184809,185382,178601,179652,706060,-5157,-2.7904485171176727
2024-04-02,178410,179269,175545,175545,539280,-2865,-1.6058516899276947
2024-04-03,173443,174112,171533,172393,500100,-1050,-0.6053862075725166
2024-04-04,174208,174494,171534,171534,334273,-2674,-1.5349467303453344
2024-04-05,170005,171247,169336,169528,350780,-477,-0.2805799829416782
2024-04-08,169050,182326,168190,180034,1101630,10984,6.4974859509021
2024-04-09,181467,182135,173158,173158,814046,-8309,-4.578793940496069
2024-04-11,169718,172584,169527,171438,550328,1720,1.0134458336770407
2024-04-12,171342,175067,170101,174017,500959,2675,1.5612050752296576
2024-04-15,171916,172680,170483,170579,379356,-1337,-0.7777053910049094
2024-04-16,169336,170292,164083,164275,665621,-5061,-2.988732460906127
2024-04-17,165421,169050,162078,163320,718771,-2101,-1.2700926726352761
2024-04-18,165134,169814,165039,169146,497186,4012,2.429542068865285
2024-04-19,167140,167522,163320,165135,527802,-2005,-1.1995931554385546
2024-04-22,167808,170674,166853,170674,450728,2866,1.7079042715484363
2024-04-23,170769,171629,169623,171629,314939,860,0.5036042841499335
2024-04-24,172106,172775,171055,171438,292281,-668,-0.38813289484387525
2024-04-25,169719,170961,168191,169433,322108,-286,-0.1685138375785858
2024-04-26,169528,170770,168382,168669,231575,-859,-0.5067009579538483
2024-04-29,170483,175545,170483,175450,672709,4967,2.913486975240933
2024-04-30,175450,182613,174781,180512,1284816,5062,2.8851524650897695
2024-05-02,179461,182135,178601,179079,550387,-382,-0.21285961852435903
2024-05-03,180416,181085,178792,180512,308848,96,0.0532103582830791
2024-05-07,182421,188152,182421,185669,1117348,3248,1.780496762982332
2024-05-08,186624,187483,184809,185860,485825,-764,-0.4093792866941015
2024-05-09,186050,187197,181180,181180,841440,-4870,-2.6175759204514915
2024-05-10,184619,188057,183377,184237,748914,-382,-0.2069126146279635
2024-05-13,184332,184618,179843,182231,464150,-2101,-1.1397912462296291
2024-05-14,180893,183090,180320,182326,290635,1433,0.7921810130850835
2024-05-16,185096,186624,183663,184332,488119,-764,-0.4127587846306781
2024-05-17,181658,183759,180034,182900,1047253,1242,0.6837023417630933
2024-05-20,184619,184810,176405,178602,554502,-6017,-3.2591445084200434
2024-05-21,177169,179366,176691,177838,250392,669,0.37760556304996923
2024-05-22,178123,179556,175926,176500,325160,-1623,-0.9111681253964956
2024-05-23,175545,177169,175259,175259,302897,-286,-0.16292118829929647
2024-05-24,174398,175544,171533,171820,510126,-2578,-1.4782279613298317
2024-05-27,172489,173062,170483,171534,420136,-955,-0.5536584941648452
2024-05-28,171534,174208,170483,172776,431335,1242,0.7240547063555913
2024-05-29,171151,171820,169145,170865,516853,-286,-0.16710390240197254
2024-05-30,169528,173252,169241,169337,374290,-191,-0.11266575432966824
2024-05-31,171629,173826,168191,168287,924398,-3342,-1.9472233713416731
2024-06-03,169241,172584,168859,170961,324383,1720,1.0163021962763161
2024-06-04,169910,181371,169910,179652,1351940,9742,5.733623683126361
2024-06-05,180893,184904,179747,181753,931989,860,0.47541917044882887
2024-06-07,183185,183949,180033,182517,517375,-668,-0.36465867838523897
2024-06-10,180033,184045,178219,180989,567325,956,0.5310137585887031
2024-06-11,181466,186242,180225,183950,821084,2484,1.3688514652882633
2024-06-12,186147,186242,178888,179175,962286,-6972,-3.745427001240955
2024-06-13,181084,182994,174399,174399,1522396,-6685,-3.6916569106050225
2024-06-14,174494,178028,171629,175163,1053795,669,0.38339427143626714
2024-06-17,175163,175640,171629,171725,633364,-3438,-1.9627432734081969
2024-06-18,171724,173061,170196,171056,478322,-668,-0.3889962963825674
2024-06-19,172775,175258,171915,175163,489745,2388,1.382144407466358
2024-06-20,174971,174971,172011,172011,386551,-2960,-1.6917089117625208
2024-06-21,171629,173252,169146,169146,1605181,-2483,-1.4467252037825775
2024-06-24,169910,172107,169719,170961,392986,1051,0.618562768524513
2024-06-25,172584,172871,169719,170388,380537,-2196,-1.2724238631622862
2024-06-26,169719,170292,168668,168860,429798,-859,-0.5061307219580601
2024-06-27,167522,168095,165994,165994,521078,-1528,-0.91211900526498
2024-06-28,166280,167522,165707,166472,346933,192,0.11546788549434688
2024-07-01,167331,175832,167331,175832,1100015,8501,5.080349725992194
2024-07-02,175831,177360,172680,176214,773095,383,0.21782279575273986
2024-07-03,176691,177073,172297,173635,480750,-3056,-1.72957309653576
2024-07-04,174590,176118,172775,174686,411712,96,0.05498596712297382
2024-07-05,175258,179078,173634,177455,757794,2197,1.2535804357005103
2024-07-08,177264,178410,174780,175163,430008,-2101,-1.1852378373499415
2024-07-09,175259,179461,175259,178793,625688,3534,2.016444233962307
2024-07-10,178601,178792,175640,176405,503752,-2196,-1.2295563854625675
2024-07-11,177741,177741,174876,177455,542335,-286,-0.16090828790205974
2024-07-12,177264,182804,177169,180321,886317,3057,1.7245464392093148
2024-07-15,182421,183376,180033,180225,560616,-2196,-1.2038087720163797
2024-07-16,181466,181562,176309,180225,557391,-1241,-0.6838746652265438
2024-07-17,180512,184619,178888,183855,1060342,3343,1.8519544407020032
2024-07-18,183376,183567,179269,179461,672420,-3915,-2.1349576825756915
2024-07-19,177646,180607,177168,179461,419242,1815,1.0216948312936964
2024-07-22,179556,185669,179270,184523,1485129,4967,2.766267905277462
2024-07-23,183854,185669,180703,180703,721073,-3151,-1.713859910581222
2024-07-24,179843,186242,178123,184714,979687,4871,2.7084735018877577
2024-07-25,185287,195793,183472,190254,2263315,4967,2.6807061477599614
2024-07-26,192450,195315,189203,191018,1090609,-1432,-0.7440893738633411
2024-07-29,193883,200569,192928,199614,1368715,5731,2.9559063971570483
2024-07-30,197703,201524,194361,199614,1092658,1911,0.9666014172774313
2024-07-31,200091,201046,191495,195316,1070686,-4775,-2.3864141815473956
2024-08-01,191973,197703,190826,191018,943861,-955,-0.49746578945997616
2024-08-02,188629,190348,183663,184905,1083212,-3724,-1.974245741640999
2024-08-05,179843,186529,165230,174304,2078099,-5539,-3.079908586934159
2024-08-06,179174,182421,173443,173826,1768430,-5348,-2.984808063669952
2024-08-07,172298,195793,172202,188153,3799539,15855,9.202080117006583
2024-08-08,188343,190444,183854,186911,1431107,-1432,-0.7603149572853782
2024-08-09,189107,192449,185859,187197,1166065,-1910,-1.0100102058622895
2024-08-12,190635,194838,189680,191018,1000724,383,0.2009074933773966
2024-08-13,190063,191018,182899,184046,1031936,-6017,-3.165792395153186
2024-08-14,185477,186528,182230,185860,708893,383,0.20649460580018006
2024-08-16,186624,191973,186242,188344,987190,1720,0.9216392318244171
2024-08-19,188630,190349,186720,188726,586463,96,0.05089328314690134
2024-08-20,189966,190635,187005,187388,513445,-2578,-1.35708495204405
2024-08-21,189107,191018,187866,190827,854068,1720,0.9095379864309623
2024-08-22,191018,195316,189108,193406,834272,2388,1.2501439654901632
2024-08-23,192928,195316,191973,193406,613852,478,0.2477608226903301
2024-08-26,195315,198180,193405,195793,647054,478,0.24473286741929703
2024-08-27,195792,199613,191017,191495,732103,-4297,-2.1946759826754922
2024-08-28,192450,194837,188916,192450,705580,0,0.0
2024-08-29,191973,195315,189967,190063,544375,-1910,-0.9949315789199523
2024-08-30,191017,195315,190922,193883,793701,2866,1.5003900176424088
2024-09-02,193883,194360,186719,188248,823679,-5635,-2.9063919992985463
2024-09-03,188057,191495,187961,188153,406378,96,0.05104835236125218
2024-09-04,181944,185478,181562,181658,806051,-286,-0.15719122367321814
2024-09-05,183472,184523,176882,179557,669897,-3915,-2.1338405860294762
2024-09-06,179652,183854,177168,182613,692276,2961,1.6481864938881838
2024-09-09,178411,184714,178315,183473,418148,5062,2.8372690024718206
2024-09-10,185477,187579,183758,187006,574948,1529,0.8243609719803533
2024-09-11,188056,188056,180224,182135,613136,-5921,-3.14853022503935
2024-09-12,182517,187197,182135,186815,691311,4298,2.3548491373406315
2024-09-13,186815,187292,185095,186433,305832,-382,-0.20448036827877847
2024-09-19,189202,193405,189202,192450,790587,3248,1.7166837559856662
2024-09-20,192927,194360,190921,192450,777141,-477,-0.24724377614330806
2024-09-23,193882,201523,193882,195793,871677,1911,0.9856510661123776
2024-09-24,196270,196270,191018,196271,504015,1,0.0005095022163346411
2024-09-25,198181,200091,190731,191018,664229,-7163,-3.614372719887376
2024-09-26,190922,192928,189107,192928,575984,2006,1.0506908580467416
2024-09-27,191972,192450,186051,186051,978278,-5921,-3.0843039609943115
2024-09-30,186815,188534,184045,186624,557282,-191,-0.10224018413938923
2024-10-02,183568,186624,182422,182422,490886,-1146,-0.6242918155669834
2024-10-04,182899,187006,182135,184046,497281,1147,0.6271220728380145
2024-10-07,185383,186529,182422,184810,381330,-573,-0.3090898302433341
2024-10-08,183663,184714,182613,182613,510849,-1050,-0.5716992535241175
2024-10-10,183854,187675,183759,185574,737667,1720,0.9355249273880363
2024-10-11,186337,189394,185478,188439,506327,2102,1.1280636695878972
2024-10-14,190157,190444,186623,187006,456937,-3151,-1.657051804561494
2024-10-15,187006,192927,186051,191495,695371,4489,2.4004577393238717
2024-10-16,190348,191972,186910,187006,653155,-3342,-1.7557316073717613
2024-10-17,187006,187674,179556,180416,1223293,-6590,-3.5239511031731605
2024-10-18,180512,182422,179270,179939,617799,-573,-0.3174304201382734
2024-10-21,180798,184046,180798,183091,463391,2293,1.2682662418832067
2024-10-22,182708,183854,178887,179079,583865,-3629,-1.9862293933489503
2024-10-23,179461,181084,176309,177360,589968,-2101,-1.170727901883975
2024-10-24,177359,178506,175927,177551,346678,192,0.10825500820369983
2024-10-25,177646,180225,174304,178029,615045,383,0.21559731150715467
2024-10-28,178314,180511,177741,179270,362571,956,0.5361328891730318
2024-10-29,179747,181466,178601,180607,371741,860,0.4784502662075028
2024-10-30,180034,180511,178792,179270,319628,-764,-0.42436428674583687
2024-10-31,178601,179079,174304,174304,553432,-4297,-2.4059215793864537
2024-11-01,172871,175163,172107,172967,349525,96,0.05553273828461685
2024-11-04,172966,178984,172202,178984,455592,6018,3.4792965091405246
2024-11-05,177264,179269,175162,176118,283848,-1146,-0.6464933658272407
2024-11-06,176404,177073,172106,176500,499024,96,0.054420534681753244
2024-11-07,175067,176404,169241,172107,630535,-2960,-1.6907812437523921
2024-11-08,174017,176405,172584,173349,451413,-668,-0.38387054138388776
2024-11-11,172011,172871,163320,166281,1051998,-5730,-3.331182308108202
2024-11-12,164848,166280,158257,158449,1166173,-6399,-3.8817577404639425
2024-11-13,157589,160646,156634,157781,684558,192,0.12183591494330187
2024-11-14,158162,161601,158162,158927,626098,765,0.4836812888051491
2024-11-15,159977,160646,153101,157972,632125,-2005,-1.2533051626171263
2024-11-18,157684,165230,156156,164848,620706,7164,4.543263742675223
2024-11-19,164274,166471,164083,164848,411427,574,0.3494162192434591
2024-11-20,164179,165325,161982,163702,355340,-477,-0.29053654852325816
2024-11-21,165230,169146,165039,165899,645841,669,0.4048901531198935
2024-11-22,166663,168573,165230,165708,364189,-955,-0.5730126062773382
2024-11-25,166185,170770,164944,168860,686387,2675,1.6096518939735835
2024-11-26,168860,170388,167140,167714,308889,-1146,-0.6786687196494138
2024-11-27,167236,170770,167236,169815,389940,2579,1.5421320768255637
2024-11-28,169719,178697,169242,178029,927969,8310,4.896328637335832
2024-11-29,178697,179843,176978,178602,723056,-95,-0.05316261604839478
2024-12-02,180797,180988,175544,176309,518402,-4488,-2.4823420742600817
2024-12-03,176500,180034,175736,178506,423203,2006,1.136543909348442
2024-12-04,173825,177646,173634,174781,763971,956,0.5499784265784554
2024-12-05,175640,178123,172297,172871,445277,-2769,-1.576520154862218
2024-12-06,172870,174207,168954,172011,629219,-859,-0.4969051888702493
2024-12-09,167140,171342,166853,167236,740089,96,0.057436879262893384
2024-12-10,168860,173922,168860,173922,459805,5062,2.997749615065735
2024-12-11,173921,176595,172966,175927,365347,2006,1.1533972320766326
2024-12-12,176500,176691,175258,176596,688360,96,0.054390934844192634
2024-12-13,177264,187292,177264,184714,1106717,7450,4.2027710082137375
2024-12-16,189107,189393,185955,187388,1144690,-1719,-0.9090091852760607
2024-12-17,187197,187197,183376,184523,1057911,-2674,-1.4284416951126355
2024-12-18,184523,190922,184523,190254,7090426,5731,3.1058458837109737
2024-12-19,185382,187674,183376,183759,712409,-1623,-0.8754895297278054
2024-12-20,182517,184332,181085,183855,435844,1338,0.7330823978040402
2024-12-23,184618,185765,183854,185192,297807,574,0.31091226207628725
2024-12-24,185191,185955,183567,185669,377351,478,0.25811189528648804
2024-12-26,185669,187484,181944,182900,639601,-2769,-1.4913636632932799
2024-12-27,183200,185800,176800,180400,571954,-2800,-1.5283842794759825
2024-12-30,180000,190200,179800,187500,531670,7500,4.166666666666666
