Date,Open,High,Low,Close,Volume,Change,ChangeRatio
2024-01-02,78200,79800,78200,79600,17142847,1400,1.7902813299232736
2024-01-03,78500,78800,77000,77000,21753644,-1500,-1.910828025477707
2024-01-04,76100,77300,76100,76600,15324439,500,0.657030223390276
2024-01-05,76700,77100,76400,76600,11304316,-100,-0.1303780964797914
2024-01-08,77000,77500,76400,76500,11088724,-500,-0.6493506493506493
2024-01-09,77400,77700,74300,74700,26019249,-2700,-3.488372093023256
2024-01-10,75000,75200,73200,73600,20259529,-1400,-1.866666666666667
2024-01-11,72900,73600,72700,73200,57691266,300,0.411522633744856
2024-01-12,73000,74100,72800,73100,13038939,100,0.136986301369863
2024-01-15,73200,74000,73200,73900,13212339,700,0.9562841530054645
2024-01-16,73500,73700,72500,72600,14760415,-900,-1.2244897959183674
2024-01-17,73100,73300,71000,71000,22683660,-2100,-2.8727770177838576
2024-01-18,71600,72000,70700,71700,17853397,100,0.13966480446927373
2024-01-19,73500,74700,73000,74700,23363427,1200,1.6326530612244898
2024-01-22,75900,76000,75000,75100,19673375,-800,-1.0540184453227932
2024-01-23,75700,75800,74300,75200,14786224,-500,-0.6605019815059445
2024-01-24,75200,75200,73500,74000,12860661,-1200,-1.5957446808510638
2024-01-25,74200,74800,73700,74100,11737747,-100,-0.13477088948787064
2024-01-26,73700,74500,73300,73400,11160062,-300,-0.40705563093622793
2024-01-29,73800,75200,73500,74400,13976521,600,0.8130081300813009
2024-01-30,75000,75300,73700,74300,12244418,-700,-0.9333333333333335
2024-01-31,73400,74000,72500,72700,15703560,-700,-0.9536784741144414
2024-02-01,73000,74200,72900,73600,19881033,600,0.821917808219178
2024-02-02,74000,75200,73700,75200,14955881,1200,1.6216216216216217
2024-02-05,74200,74800,73500,74300,19026021,100,0.13477088948787064
2024-02-06,74300,74700,73300,74400,14559254,100,0.13458950201884254
2024-02-07,74600,75500,74300,75000,16566445,400,0.5361930294906166
2024-02-08,75000,75200,73600,74100,20810708,-900,-1.2
2024-02-13,74800,75200,74400,75200,21966745,400,0.53475935828877
2024-02-14,73700,74300,73700,74000,12434945,300,0.40705563093622793
2024-02-15,74200,74400,73000,73000,14120600,-1200,-1.6172506738544474
2024-02-16,73300,73400,72500,72800,13444781,-500,-0.6821282401091405
2024-02-19,72800,73900,72800,73800,12726404,1000,1.3736263736263736
2024-02-20,73700,73700,72800,73300,14681477,-400,-0.5427408412483039
2024-02-21,73400,73700,72900,73000,11503495,-400,-0.544959128065395
2024-02-22,73800,73900,72700,73100,15208934,-700,-0.9485094850948509
2024-02-23,73600,74200,72900,72900,16225166,-700,-0.9510869565217392
2024-02-26,72300,73200,72200,72800,14669352,500,0.6915629322268326
2024-02-27,73100,73400,72700,72900,13201981,-200,-0.27359781121751026
2024-02-28,72900,73900,72800,73200,11795859,300,0.411522633744856
2024-02-29,72600,73400,72000,73400,21176403,800,1.1019283746556474
2024-03-04,74300,75000,74000,74900,23210474,600,0.8075370121130552
2024-03-05,74600,74800,73700,73700,19505125,-900,-1.2064343163538873
2024-03-06,73200,73500,72700,72900,21547905,-300,-0.4098360655737705
2024-03-07,73100,73300,72200,72200,14516963,-900,-1.231190150478796
2024-03-08,72800,73400,72600,73300,19271349,500,0.6868131868131868
2024-03-11,72900,73100,72300,72400,9740504,-500,-0.6858710562414266
2024-03-12,72600,73500,72100,73300,13011654,700,0.9641873278236914
2024-03-13,73700,74100,73500,74100,15243134,400,0.5427408412483039
2024-03-14,74400,74500,73600,74300,22545539,-100,-0.13440860215053765
2024-03-15,73400,73700,72300,72300,22580555,-1100,-1.4986376021798364
2024-03-18,72600,73000,72500,72800,11520348,200,0.27548209366391185
2024-03-19,72300,73000,71700,72800,15376066,500,0.6915629322268326
2024-03-20,73700,77200,73400,76900,50106297,3200,4.341926729986431
2024-03-21,79200,79300,77700,79300,44569799,100,0.12626262626262627
2024-03-22,79600,79900,77800,78900,26724761,-700,-0.8793969849246231
2024-03-25,79600,79800,77800,78200,18703996,-1400,-1.7587939698492463
2024-03-26,79700,80100,79200,79900,30551494,200,0.2509410288582183
2024-03-27,79200,80000,79200,79800,17424595,600,0.7575757575757576
2024-03-28,79400,81000,79200,80800,25084812,1400,1.7632241813602016
2024-03-29,81200,82500,80900,82400,27126366,1200,1.477832512315271
2024-04-01,83200,83300,82000,82000,20116513,-1200,-1.4423076923076923
2024-04-02,82900,85000,82900,85000,37077944,2100,2.5331724969843186
2024-04-03,84300,85000,83500,84100,30493347,-200,-0.2372479240806643
2024-04-04,85200,85500,84300,85300,25248934,100,0.11737089201877934
2024-04-05,84500,85000,83800,84500,18883752,0,0.0
2024-04-08,85200,86000,84500,84500,18953232,-700,-0.8215962441314555
2024-04-09,84500,84900,83100,83600,23725956,-900,-1.0650887573964496
2024-04-11,83200,84700,82500,84100,25538009,900,1.0817307692307692
2024-04-12,84700,84900,83200,83700,17061770,-1000,-1.1806375442739079
2024-04-15,82900,83200,81200,82200,26663772,-700,-0.8443908323281062
2024-04-16,81200,81300,79400,80000,31949845,-1200,-1.477832512315271
2024-04-17,80700,80800,78900,78900,22611631,-1800,-2.2304832713754648
2024-04-18,78800,80100,78300,79600,21370190,800,1.015228426395939
2024-04-19,78300,78700,76300,77600,31317563,-700,-0.8939974457215836
2024-04-22,77400,77500,75100,76100,30469477,-1300,-1.6795865633074936
2024-04-23,76400,76800,75500,75500,18717699,-900,-1.1780104712041886
2024-04-24,77500,78800,77200,78600,22166150,1100,1.4193548387096775
2024-04-25,77300,77500,76300,76300,15549134,-1000,-1.29366106080207
2024-04-26,77800,77900,76500,76700,12755629,-1100,-1.4138817480719794
2024-04-29,77400,77600,76200,76700,14664474,-700,-0.9043927648578811
2024-04-30,77000,78500,76600,77500,19007007,500,0.6493506493506493
2024-05-02,77600,78600,77300,78000,18900640,400,0.5154639175257731
2024-05-03,79000,79000,77500,77600,13151889,-1400,-1.7721518987341773
2024-05-07,79600,81300,79400,81300,26238868,1700,2.135678391959799
2024-05-08,80800,81400,80500,81300,13089576,500,0.6188118811881188
2024-05-09,81100,81500,79700,79700,18759935,-1400,-1.726263871763255
2024-05-10,80400,81100,78900,79200,16976124,-1200,-1.4925373134328357
2024-05-13,79400,79900,77600,78400,18652344,-1000,-1.2594458438287155
2024-05-14,78600,78800,77900,78300,11763992,-300,-0.38167938931297707
2024-05-16,80200,80300,78100,78200,20989778,-2000,-2.493765586034913
2024-05-17,78600,78800,77200,77400,15918201,-1200,-1.5267175572519083
2024-05-20,78100,79100,77900,78900,19456783,800,1.0243277848911652
2024-05-21,78500,79000,78200,78400,13690583,-100,-0.12738853503184713
2024-05-22,78100,78700,77300,77700,19521506,-400,-0.5121638924455826
2024-05-23,77700,79100,77100,78300,18728087,600,0.7722007722007722
2024-05-24,76800,77000,75700,75900,27891278,-900,-1.171875
2024-05-27,75300,78200,74000,77200,43825202,1900,2.5232403718459495
2024-05-28,76500,78000,76200,77600,18539072,1100,1.4379084967320261
2024-05-29,77700,78200,75200,75200,30244875,-2500,-3.2175032175032174
2024-05-30,74800,75200,73500,73500,28551273,-1300,-1.7379679144385027
2024-05-31,74500,74700,73500,73500,26198776,-1000,-1.342281879194631
2024-06-03,74400,76400,74200,75700,15706268,1300,1.747311827956989
2024-06-04,74900,76100,74900,75300,14098053,400,0.5340453938584779
2024-06-05,78000,78000,76800,77400,23177968,-600,-0.7692307692307693
2024-06-07,78400,78600,77100,77300,21189349,-1100,-1.403061224489796
2024-06-10,76100,76600,75600,75700,14598755,-400,-0.5256241787122208
2024-06-11,75900,76000,75100,75200,16971175,-700,-0.922266139657444
2024-06-12,75300,77100,75200,76500,19246725,1200,1.593625498007968
2024-06-13,78400,79000,77800,78600,33763804,200,0.25510204081632654
2024-06-14,79700,80500,79000,79600,22926612,-100,-0.12547051442910914
2024-06-17,79200,79500,78000,78100,16123051,-1100,-1.3888888888888888
2024-06-18,78700,80200,78600,79800,18207598,1100,1.3977128335451081
2024-06-19,81100,82500,80500,81200,24168863,100,0.12330456226880394
2024-06-20,81500,82200,81200,81600,20288913,100,0.1226993865030675
2024-06-21,80700,80800,80000,80000,17907523,-700,-0.8674101610904585
2024-06-24,79700,80900,79500,80600,15454227,900,1.1292346298619824
2024-06-25,80600,81800,80100,80800,19088458,200,0.24813895781637718
2024-06-26,80100,81400,79900,81300,17783242,1200,1.4981273408239701
2024-06-27,81300,81600,80500,81600,11739720,300,0.36900369003690037
2024-06-28,81900,81900,80800,81500,9455929,-400,-0.4884004884004884
2024-07-01,81500,82100,81300,81800,11317202,300,0.36809815950920244
2024-07-02,82500,82600,81500,81800,14471904,-700,-0.8484848484848486
2024-07-03,82300,82300,81000,81800,11440328,-500,-0.6075334143377886
2024-07-04,82900,84700,82400,84600,43857229,1700,2.0506634499396865
2024-07-05,85600,87100,85200,87100,45791193,1500,1.7523364485981308
2024-07-08,87900,88600,86900,87400,24035809,-500,-0.5688282138794084
2024-07-09,87800,88200,86900,87800,21336201,0,0.0
2024-07-10,87600,88000,87100,87800,17813847,200,0.228310502283105
2024-07-11,88500,88800,86700,87600,24677608,-900,-1.0169491525423728
2024-07-12,85900,86100,84100,84400,26344386,-1500,-1.7462165308498252
2024-07-15,84700,87300,84100,86700,25193080,2000,2.3612750885478158
2024-07-16,86900,88000,86700,87700,16166688,800,0.9205983889528193
2024-07-17,87100,88000,86400,86700,18186490,-400,-0.4592422502870264
2024-07-18,83800,86900,83800,86900,24721790,3100,3.699284009546539
2024-07-19,85600,86100,84100,84400,18569122,-1200,-1.4018691588785046
2024-07-22,84400,84900,82600,83000,18987560,-1400,-1.6587677725118484
2024-07-23,84200,84700,83400,83900,15766389,-300,-0.35629453681710216
2024-07-24,82900,83300,81900,82000,16939083,-900,-1.0856453558504222
2024-07-25,80400,81000,80100,80400,20323811,0,0.0
2024-07-26,80700,81300,80400,80900,14508334,200,0.24783147459727387
2024-07-29,81600,82000,81100,81200,12797136,-400,-0.49019607843137253
2024-07-30,80400,81000,80000,81000,13169636,600,0.7462686567164178
2024-07-31,81200,83900,80900,83900,20744323,2700,3.32512315270936
2024-08-01,86000,86100,83100,83100,20900338,-2900,-3.372093023255814
2024-08-02,81000,81400,79500,79600,25800275,-1400,-1.728395061728395
2024-08-05,76700,76900,70200,71400,54608790,-5300,-6.910039113428944
2024-08-06,74900,75300,72300,72500,47295226,-2400,-3.204272363150868
2024-08-07,73000,76000,72800,74700,32710428,1700,2.328767123287671
2024-08-08,73200,73900,72500,73400,28414729,200,0.273224043715847
2024-08-09,75700,75800,74200,74700,16388222,-1000,-1.321003963011889
2024-08-12,75200,75900,74800,75500,9839259,300,0.39893617021276595
2024-08-13,76500,76600,75500,76100,10716261,-400,-0.522875816993464
2024-08-14,77400,77800,77000,77200,13246168,-200,-0.2583979328165375
2024-08-16,79400,80200,78700,80200,22061478,800,1.0075566750629723
2024-08-19,80100,80100,78000,78300,14146565,-1800,-2.247191011235955
2024-08-20,79500,79800,78700,78900,10683836,-600,-0.7547169811320755
2024-08-21,77900,78600,77800,78300,7805598,400,0.5134788189987163
2024-08-22,78700,78900,77800,78300,8149101,-400,-0.5082592121982211
2024-08-23,77700,78400,77500,77700,9420306,0,0.0
2024-08-26,78100,78200,76000,76100,15655938,-2000,-2.560819462227913
2024-08-27,75700,76500,75600,75800,11130145,100,0.13210039630118892
2024-08-28,75800,76400,75400,76400,9794514,600,0.79155672823219
2024-08-29,73600,74700,73500,74000,16884479,400,0.5434782608695652
2024-08-30,74400,75000,74100,74300,16358520,-100,-0.13440860215053765
2024-09-02,74500,74700,73500,74400,12641376,-100,-0.1342281879194631
2024-09-03,74100,74300,72500,72500,16314599,-1600,-2.1592442645074224
2024-09-04,69800,71100,69800,70000,27366563,200,0.28653295128939826
2024-09-05,70100,71200,69000,69000,25686769,-1100,-1.5691868758915835
2024-09-06,69100,69700,68000,68900,19022299,-200,-0.2894356005788712
2024-09-09,66900,68200,66600,67500,23263298,600,0.8968609865470852
2024-09-10,67000,67300,66000,66200,30651376,-800,-1.1940298507462688
2024-09-11,65100,65500,64200,64900,35809707,-200,-0.30721966205837176
2024-09-12,66000,66600,65200,66300,35884106,300,0.45454545454545453
2024-09-13,65000,65500,64300,64400,25045135,-600,-0.9230769230769231
2024-09-19,64000,64400,62200,63100,49402713,-900,-1.40625
2024-09-20,63800,64700,63000,63000,32746056,-800,-1.2539184952978055
2024-09-23,62300,63500,62200,62600,28542376,300,0.4815409309791332
2024-09-24,62800,63400,62400,63200,26957500,400,0.6369426751592357
2024-09-25,63800,64200,62200,62200,28652438,-1600,-2.507836990595611
2024-09-26,63900,64900,63700,64700,37566015,800,1.2519561815336464
2024-09-27,64700,65400,64200,64200,28433030,-500,-0.7727975270479135
2024-09-30,64200,64300,61500,61500,32694163,-2700,-4.205607476635514
2024-10-02,60500,61900,59900,61300,28473536,800,1.322314049586777
2024-10-04,61000,61700,60500,60600,24247578,-400,-0.6557377049180327
2024-10-07,60200,61900,59500,61000,35066533,800,1.3289036544850499
2024-10-08,60000,61000,59900,60300,27411786,300,0.5
2024-10-10,60100,60200,58900,58900,45262214,-1200,-1.9966722129783694
2024-10-11,59100,60100,59000,59300,29623969,200,0.338409475465313
2024-10-14,59500,61200,59400,60800,20886249,1300,2.1848739495798317
2024-10-15,61100,61400,60100,61000,22715239,-100,-0.16366612111292964
2024-10-16,59400,60000,59200,59500,23303268,100,0.16835016835016833
2024-10-17,59400,60100,59100,59700,23372873,300,0.5050505050505051
2024-10-18,59900,60100,59100,59200,14420260,-700,-1.1686143572621035
2024-10-21,59000,59600,58500,59000,18514905,0,0.0
2024-10-22,58800,58900,57700,57700,27582527,-1100,-1.870748299319728
2024-10-23,57500,60000,57100,59100,27300780,1600,2.782608695652174
2024-10-24,58200,58500,56600,56600,31499922,-1600,-2.7491408934707904
2024-10-25,56000,56900,55800,55900,25829315,-100,-0.17857142857142858
2024-10-28,55700,58500,55700,58100,27775009,2400,4.308797127468582
2024-10-29,58000,59600,57300,59600,28369314,1600,2.7586206896551726
2024-10-30,59100,59800,58600,59100,19838511,0,0.0
2024-10-31,58500,61200,58300,59200,35809196,700,1.1965811965811968
2024-11-01,59000,59600,58100,58300,19083180,-700,-1.1864406779661016
2024-11-04,58600,59400,58400,58700,15586947,100,0.17064846416382254
2024-11-05,57800,58100,57200,57600,17484474,-200,-0.34602076124567477
2024-11-06,57600,58000,56300,57300,22092218,-300,-0.5208333333333333
2024-11-07,56900,58100,56800,57500,17043102,600,1.054481546572935
2024-11-08,58000,58300,57000,57000,13877396,-1000,-1.7241379310344827
2024-11-11,56700,56800,55000,55000,29811326,-1700,-2.9982363315696645
2024-11-12,54600,54600,53000,53000,37962881,-1600,-2.93040293040293
2024-11-13,52000,53000,50500,50600,52527995,-1400,-2.6923076923076925
2024-11-14,50200,51800,49900,49900,48510715,-300,-0.5976095617529881
2024-11-15,50300,54200,50300,53500,46774485,3200,6.36182902584493
2024-11-18,57000,57500,55900,56700,48095234,-300,-0.5263157894736842
2024-11-19,56500,57500,55900,56300,31539632,-200,-0.35398230088495575
2024-11-20,56100,56500,54800,55300,20864667,-800,-1.4260249554367201
2024-11-21,54900,56900,54700,56400,19096850,1500,2.73224043715847
2024-11-22,56000,56700,55900,56000,15281543,0,0.0
2024-11-25,57400,57900,56700,57900,36237325,500,0.8710801393728222
2024-11-26,57900,58900,57500,58300,23209405,400,0.690846286701209
2024-11-27,57700,57800,56000,56300,21808387,-1400,-2.4263431542461005
2024-11-28,56000,56400,55200,55500,20001134,-500,-0.8928571428571428
2024-11-29,55100,55300,53800,54200,24513531,-900,-1.6333938294010888
2024-12-02,54300,54400,53100,53600,22044867,-700,-1.289134438305709
2024-12-03,53100,54400,53100,53600,23374603,500,0.9416195856873822
2024-12-04,52000,53400,52000,53100,29004766,1100,2.1153846153846154
2024-12-05,53200,54400,53200,53700,23588277,500,0.9398496240601504
2024-12-06,53900,54400,52700,54100,22861874,200,0.3710575139146568
2024-12-09,53500,54600,53200,53400,26227680,-100,-0.1869158878504673
2024-12-10,54500,54500,53700,54000,20783970,-500,-0.9174311926605505
2024-12-11,53600,54200,53400,54000,14565947,400,0.7462686567164178
2024-12-12,54000,56500,53900,55900,33476698,1900,3.5185185185185186
2024-12-13,55800,56300,55500,56100,15908823,300,0.5376344086021506
2024-12-16,56300,56600,55200,55600,15277277,-700,-1.2433392539964476
2024-12-17,54700,55200,54000,54200,20215230,-500,-0.9140767824497258
2024-12-18,54100,55400,54000,54900,13698937,800,1.478743068391867
2024-12-19,53500,53800,53100,53100,22481925,-400,-0.7476635514018692
2024-12-20,52700,53100,51900,53000,24674774,300,0.5692599620493358
2024-12-23,53400,54000,53300,53500,13672650,100,0.18726591760299627
2024-12-24,53700,54500,53600,54400,11634677,700,1.303538175046555
2024-12-26,54500,54600,53500,53600,10517075,-900,-1.651376146788991
2024-12-27,53500,54100,53200,53700,10747196,200,0.3738317757009346
2024-12-30,53300,54000,53100,53200,12624702,-100,-0.18761726078799248
