Date,Open,High,Low,Close,Volume,Change,ChangeRatio
2024-01-02,760000,800000,756000,789000,199238,29000,3.8157894736842106
2024-01-03,782000,793000,776000,787000,87350,5000,0.639386189258312
2024-01-04,782000,784000,759000,770000,77785,-12000,-1.5345268542199488
2024-01-05,765000,769000,753000,756000,60943,-9000,-1.1764705882352942
2024-01-08,763000,763000,746000,749000,60440,-14000,-1.834862385321101
2024-01-09,757000,758000,751000,752000,32301,-5000,-0.6605019815059445
2024-01-10,758000,758000,745000,746000,25263,-12000,-1.58311345646438
2024-01-11,750000,765000,746000,751000,51085,1000,0.13333333333333333
2024-01-12,752000,758000,740000,744000,36332,-8000,-1.0638297872340425
2024-01-15,742000,768000,739000,764000,56061,22000,2.964959568733154
2024-01-16,765000,777000,755000,766000,71224,1000,0.130718954248366
2024-01-17,770000,770000,755000,756000,66807,-14000,-1.8181818181818181
2024-01-18,756000,760000,748000,750000,45252,-6000,-0.7936507936507936
2024-01-19,751000,771000,747000,770000,92506,19000,2.5299600532623168
2024-01-22,775000,793000,771000,793000,136637,18000,2.3225806451612905
2024-01-23,793000,799000,789000,799000,77547,6000,0.7566204287515763
2024-01-24,797000,808000,783000,788000,86457,-9000,-1.1292346298619824
2024-01-25,795000,800000,779000,785000,96679,-10000,-1.257861635220126
2024-01-26,778000,781000,767000,773000,58880,-5000,-0.6426735218508998
2024-01-29,800000,815000,793000,800000,194799,0,0.0
2024-01-30,800000,829000,800000,823000,147117,23000,2.875
2024-01-31,823000,845000,822000,840000,149788,17000,2.0656136087484813
2024-02-01,829000,835000,816000,829000,86022,0,0.0
2024-02-02,823000,862000,822000,859000,134042,36000,4.374240583232078
2024-02-05,851000,867000,840000,847000,79000,-4000,-0.4700352526439483
2024-02-06,857000,878000,841000,846000,78915,-11000,-1.2835472578763127
2024-02-07,849000,852000,825000,826000,97535,-23000,-2.7090694935217905
2024-02-08,831000,833000,802000,815000,99897,-16000,-1.9253910950661854
2024-02-13,817000,842000,817000,838000,87548,21000,2.570379436964504
2024-02-14,832000,833000,815000,828000,53356,-4000,-0.4807692307692308
2024-02-15,835000,835000,818000,821000,48715,-14000,-1.6766467065868262
2024-02-16,829000,829000,815000,828000,61091,-1000,-0.12062726176115801
2024-02-19,820000,827000,818000,821000,56712,1000,0.12195121951219512
2024-02-20,819000,824000,815000,818000,50674,-1000,-0.1221001221001221
2024-02-21,822000,824000,817000,823000,90685,1000,0.12165450121654502
2024-02-22,825000,832000,818000,820000,39730,-5000,-0.6060606060606061
2024-02-23,819000,828000,806000,814000,71915,-5000,-0.6105006105006106
2024-02-26,817000,822000,809000,810000,64612,-7000,-0.8567931456548347
2024-02-27,816000,816000,803000,807000,57386,-9000,-1.1029411764705883
2024-02-28,807000,812000,796000,801000,57242,-6000,-0.7434944237918215
2024-02-29,796000,801000,772000,774000,137601,-22000,-2.763819095477387
2024-03-04,777000,784000,772000,774000,82555,-3000,-0.3861003861003861
2024-03-05,770000,794000,768000,780000,53508,10000,1.2987012987012987
2024-03-06,778000,793000,777000,785000,37169,7000,0.8997429305912596
2024-03-07,794000,812000,786000,796000,86253,2000,0.2518891687657431
2024-03-08,813000,845000,812000,838000,186051,25000,3.075030750307503
2024-03-11,842000,843000,825000,830000,63779,-12000,-1.4251781472684086
2024-03-12,836000,841000,826000,840000,46577,4000,0.4784688995215311
2024-03-13,842000,848000,819000,828000,59985,-14000,-1.66270783847981
2024-03-14,830000,840000,825000,840000,75301,10000,1.2048192771084338
2024-03-15,837000,855000,826000,826000,90093,-11000,-1.3142174432497014
2024-03-18,834000,880000,826000,859000,173754,25000,2.997601918465228
2024-03-19,860000,861000,845000,848000,58733,-12000,-1.3953488372093024
2024-03-20,854000,865000,846000,850000,67582,-4000,-0.468384074941452
2024-03-21,853000,858000,830000,857000,76873,4000,0.4689331770222743
2024-03-22,851000,856000,840000,840000,52133,-11000,-1.2925969447708578
2024-03-25,847000,852000,835000,840000,47393,-7000,-0.8264462809917356
2024-03-26,846000,849000,826000,828000,69691,-18000,-2.127659574468085
2024-03-27,828000,837000,827000,836000,34924,8000,0.966183574879227
2024-03-28,832000,836000,826000,833000,35639,1000,0.1201923076923077
2024-03-29,833000,848000,828000,831000,48645,-2000,-0.24009603841536614
2024-04-01,838000,838000,816000,816000,56352,-22000,-2.6252983293556085
2024-04-02,813000,822000,810000,816000,42986,3000,0.36900369003690037
2024-04-03,811000,824000,811000,812000,50722,1000,0.12330456226880394
2024-04-04,816000,823000,812000,817000,34651,1000,0.12254901960784313
2024-04-05,812000,816000,804000,813000,39178,1000,0.12315270935960591
2024-04-08,808000,821000,798000,815000,38397,7000,0.8663366336633664
2024-04-09,819000,821000,805000,805000,39596,-14000,-1.7094017094017095
2024-04-11,796000,803000,785000,795000,61233,-1000,-0.12562814070351758
2024-04-12,795000,801000,787000,790000,41353,-5000,-0.628930817610063
2024-04-15,784000,794000,777000,793000,31597,9000,1.1479591836734695
2024-04-16,787000,794000,781000,785000,43773,-2000,-0.25412960609911056
2024-04-17,785000,787000,776000,776000,29827,-9000,-1.1464968152866242
2024-04-18,780000,797000,777000,790000,33200,10000,1.282051282051282
2024-04-19,784000,789000,770000,781000,55678,-3000,-0.3826530612244898
2024-04-22,790000,805000,788000,802000,59922,12000,1.5189873417721518
2024-04-23,795000,800000,789000,791000,44112,-4000,-0.5031446540880503
2024-04-24,799000,804000,788000,790000,48667,-9000,-1.1264080100125156
2024-04-25,783000,789000,775000,780000,68732,-3000,-0.38314176245210724
2024-04-26,779000,780000,769000,770000,82298,-9000,-1.1553273427471118
2024-04-29,775000,778000,768000,775000,90707,0,0.0
2024-04-30,776000,787000,775000,781000,60733,5000,0.6443298969072164
2024-05-02,777000,783000,774000,775000,49111,-2000,-0.2574002574002574
2024-05-03,779000,781000,771000,771000,56064,-8000,-1.0269576379974326
2024-05-07,777000,790000,777000,785000,87824,8000,1.0296010296010296
2024-05-08,795000,803000,790000,791000,82414,-4000,-0.5031446540880503
2024-05-09,796000,796000,779000,781000,82989,-15000,-1.8844221105527637
2024-05-10,789000,794000,783000,787000,65984,-2000,-0.25348542458808615
2024-05-13,791000,794000,780000,781000,35239,-10000,-1.2642225031605563
2024-05-14,783000,789000,779000,781000,28625,-2000,-0.2554278416347382
2024-05-16,786000,791000,781000,784000,65778,-2000,-0.2544529262086514
2024-05-17,783000,791000,782000,788000,45694,5000,0.6385696040868455
2024-05-20,792000,793000,785000,790000,40399,-2000,-0.25252525252525254
2024-05-21,785000,787000,779000,779000,58316,-6000,-0.7643312101910829
2024-05-22,781000,787000,776000,777000,41152,-4000,-0.5121638924455826
2024-05-23,773000,779000,770000,770000,73622,-3000,-0.38809831824062097
2024-05-24,763000,766000,751000,751000,81016,-12000,-1.5727391874180863
2024-05-27,754000,759000,746000,755000,44353,1000,0.1326259946949602
2024-05-28,754000,755000,745000,745000,52416,-9000,-1.1936339522546418
2024-05-29,739000,747000,726000,727000,89242,-12000,-1.6238159675236805
2024-05-30,726000,744000,721000,732000,38342,6000,0.8264462809917356
2024-05-31,739000,740000,728000,730000,51389,-9000,-1.2178619756427604
2024-06-03,736000,756000,736000,752000,49828,16000,2.1739130434782608
2024-06-04,746000,757000,746000,753000,33080,7000,0.938337801608579
2024-06-05,757000,774000,751000,760000,64528,3000,0.3963011889035667
2024-06-07,762000,769000,747000,750000,57654,-12000,-1.574803149606299
2024-06-10,742000,742000,733000,736000,68070,-6000,-0.8086253369272237
2024-06-11,740000,755000,739000,740000,48332,0,0.0
2024-06-12,741000,750000,736000,742000,59766,1000,0.1349527665317139
2024-06-13,743000,755000,736000,736000,95600,-7000,-0.9421265141318977
2024-06-14,736000,739000,733000,737000,51252,1000,0.1358695652173913
2024-06-17,735000,737000,730000,736000,37449,1000,0.13605442176870747
2024-06-18,739000,744000,733000,740000,46315,1000,0.13531799729364005
2024-06-19,746000,756000,742000,755000,55640,9000,1.2064343163538873
2024-06-20,753000,756000,747000,747000,33185,-6000,-0.796812749003984
2024-06-21,747000,751000,738000,750000,61956,3000,0.4016064257028112
2024-06-24,747000,748000,734000,734000,45936,-13000,-1.7402945113788488
2024-06-25,740000,740000,732000,738000,42342,-2000,-0.2702702702702703
2024-06-26,738000,739000,728000,729000,64022,-9000,-1.2195121951219512
2024-06-27,725000,733000,722000,732000,49191,7000,0.9655172413793104
2024-06-28,732000,734000,724000,727000,76001,-5000,-0.6830601092896175
2024-07-01,727000,769000,725000,759000,146791,32000,4.401650618982118
2024-07-02,756000,815000,753000,810000,310729,54000,7.142857142857142
2024-07-03,805000,818000,792000,810000,156413,5000,0.6211180124223602
2024-07-04,810000,810000,795000,803000,72898,-7000,-0.8641975308641975
2024-07-05,808000,808000,798000,803000,63043,-5000,-0.6188118811881188
2024-07-08,806000,808000,784000,792000,80840,-14000,-1.7369727047146404
2024-07-09,796000,808000,791000,796000,54942,0,0.0
2024-07-10,796000,815000,792000,807000,81410,11000,1.3819095477386936
2024-07-11,814000,823000,805000,815000,82472,1000,0.12285012285012285
2024-07-12,815000,825000,813000,823000,86531,8000,0.98159509202454
2024-07-15,830000,832000,816000,819000,62533,-11000,-1.3253012048192772
2024-07-16,825000,827000,816000,824000,51060,-1000,-0.12121212121212122
2024-07-17,818000,859000,818000,851000,175009,33000,4.034229828850855
2024-07-18,850000,856000,842000,850000,94995,0,0.0
2024-07-19,842000,844000,821000,835000,69248,-7000,-0.831353919239905
2024-07-22,833000,857000,826000,848000,123049,15000,1.800720288115246
2024-07-23,852000,865000,845000,848000,73358,-4000,-0.4694835680751174
2024-07-24,845000,890000,836000,883000,271622,38000,4.497041420118343
2024-07-25,880000,890000,858000,871000,190763,-9000,-1.0227272727272727
2024-07-26,873000,929000,872000,915000,249017,42000,4.810996563573884
2024-07-29,919000,950000,915000,940000,145349,21000,2.2850924918389555
2024-07-30,940000,960000,928000,937000,144798,-3000,-0.3191489361702127
2024-07-31,945000,955000,925000,938000,108408,-7000,-0.7407407407407408
2024-08-01,928000,928000,901000,925000,144939,-3000,-0.3232758620689655
2024-08-02,912000,927000,903000,911000,101110,-1000,-0.10964912280701754
2024-08-05,898000,924000,853000,890000,251507,-8000,-0.8908685968819599
2024-08-06,923000,939000,901000,928000,191447,5000,0.5417118093174431
2024-08-07,927000,979000,925000,960000,280891,33000,3.559870550161812
2024-08-08,960000,977000,945000,974000,134857,14000,1.4583333333333333
2024-08-09,981000,986000,955000,960000,101827,-21000,-2.1406727828746175
2024-08-12,962000,974000,944000,950000,82141,-12000,-1.2474012474012475
2024-08-13,944000,949000,925000,939000,87052,-5000,-0.5296610169491525
2024-08-14,941000,941000,912000,932000,117666,-9000,-0.9564293304994688
2024-08-16,940000,943000,925000,931000,96605,-9000,-0.9574468085106382
2024-08-19,933000,954000,922000,930000,106682,-3000,-0.3215434083601286
2024-08-20,931000,934000,902000,907000,122594,-24000,-2.577873254564984
2024-08-21,913000,948000,913000,948000,150458,35000,3.8335158817086525
2024-08-22,946000,965000,936000,955000,121834,9000,0.9513742071881607
2024-08-23,955000,964000,948000,957000,51741,2000,0.20942408376963353
2024-08-26,964000,964000,948000,962000,43653,-2000,-0.2074688796680498
2024-08-27,967000,1005000,967000,973000,238431,6000,0.6204756980351602
2024-08-28,979000,1004000,974000,991000,171180,12000,1.2257405515832482
2024-08-29,991000,995000,954000,956000,106423,-35000,-3.5317860746720484
2024-08-30,956000,988000,956000,980000,87602,24000,2.510460251046025
2024-09-02,990000,991000,955000,965000,54568,-25000,-2.525252525252525
2024-09-03,966000,979000,959000,961000,48087,-5000,-0.5175983436853002
2024-09-04,940000,952000,934000,946000,81547,6000,0.6382978723404255
2024-09-05,948000,954000,922000,935000,92973,-13000,-1.3713080168776373
2024-09-06,935000,973000,929000,965000,123527,30000,3.2085561497326207
2024-09-09,952000,973000,950000,965000,54630,13000,1.365546218487395
2024-09-10,973000,1010000,969000,996000,173992,23000,2.36382322713258
2024-09-11,1002000,1014000,970000,981000,112791,-21000,-2.095808383233533
2024-09-12,987000,987000,967000,971000,94425,-16000,-1.6210739614994936
2024-09-13,980000,996000,970000,990000,71202,10000,1.0204081632653061
2024-09-19,1013000,1050000,1006000,1049000,222731,36000,3.5538005923000986
2024-09-20,1047000,1063000,1037000,1060000,152366,13000,1.241642788920726
2024-09-23,1058000,1096000,1051000,1087000,158056,29000,2.7410207939508506
2024-09-24,1085000,1091000,1061000,1082000,105027,-3000,-0.2764976958525346
2024-09-25,1098000,1109000,1036000,1047000,144011,-51000,-4.644808743169399
2024-09-26,1047000,1055000,1030000,1052000,90567,5000,0.4775549188156638
2024-09-27,1047000,1048000,986000,986000,215610,-61000,-5.826170009551098
2024-09-30,984000,1003000,973000,977000,128574,-7000,-0.7113821138211381
2024-10-02,973000,985000,958000,977000,94400,4000,0.41109969167523125
2024-10-04,988000,1016000,979000,999000,138681,11000,1.1133603238866396
2024-10-07,1006000,1007000,990000,1001000,68579,-5000,-0.4970178926441352
2024-10-08,994000,1009000,992000,1004000,53272,10000,1.0060362173038229
2024-10-10,1009000,1033000,995000,995000,88971,-14000,-1.3875123885034688
2024-10-11,1011000,1033000,992000,1024000,97065,13000,1.2858555885262115
2024-10-14,1024000,1037000,1017000,1036000,71648,12000,1.171875
2024-10-15,1035000,1096000,1030000,1082000,133451,47000,4.541062801932367
2024-10-16,1071000,1082000,1056000,1057000,73438,-14000,-1.3071895424836601
2024-10-17,1058000,1063000,1018000,1026000,85632,-32000,-3.0245746691871456
2024-10-18,1033000,1072000,1025000,1060000,81537,27000,2.6137463697967087
2024-10-21,1070000,1104000,1065000,1091000,135864,21000,1.9626168224299065
2024-10-22,1085000,1113000,1055000,1059000,143151,-26000,-2.3963133640553
2024-10-23,1070000,1095000,1054000,1059000,101156,-11000,-1.0280373831775702
2024-10-24,1063000,1066000,1021000,1041000,105621,-22000,-2.06961429915334
2024-10-25,1038000,1082000,1021000,1061000,85114,23000,2.2157996146435455
2024-10-28,1067000,1078000,1047000,1058000,60587,-9000,-0.8434864104967198
2024-10-29,1057000,1079000,1041000,1047000,53287,-10000,-0.9460737937559129
2024-10-30,1036000,1046000,1019000,1031000,64899,-5000,-0.4826254826254826
2024-10-31,1030000,1030000,1000000,1002000,90508,-28000,-2.7184466019417477
2024-11-01,995000,1011000,995000,998000,42741,3000,0.3015075376884422
2024-11-04,1000000,1017000,987000,1017000,81421,17000,1.7000000000000002
2024-11-05,1015000,1033000,1005000,1008000,63047,-7000,-0.6896551724137931
2024-11-06,1013000,1040000,998000,1026000,103863,13000,1.2833168805528135
2024-11-07,1016000,1030000,969000,995000,126818,-21000,-2.066929133858268
2024-11-08,1003000,1014000,998000,1004000,65322,1000,0.09970089730807577
2024-11-11,999000,1018000,986000,1007000,85138,8000,0.8008008008008007
2024-11-12,1001000,1011000,981000,987000,82207,-14000,-1.3986013986013985
2024-11-13,978000,987000,947000,950000,90569,-28000,-2.8629856850715747
2024-11-14,951000,972000,943000,957000,77243,6000,0.6309148264984227
2024-11-15,956000,964000,929000,937000,281564,-19000,-1.9874476987447698
2024-11-18,915000,932000,907000,916000,88698,1000,0.1092896174863388
2024-11-19,917000,937000,917000,919000,74830,2000,0.21810250817884408
2024-11-20,942000,953000,915000,938000,94198,-4000,-0.42462845010615713
2024-11-21,944000,963000,932000,932000,130862,-12000,-1.2711864406779663
2024-11-22,939000,939000,926000,934000,79868,-5000,-0.5324813631522897
2024-11-25,941000,960000,933000,958000,111598,17000,1.8065887353878853
2024-11-26,949000,955000,921000,929000,89808,-20000,-2.107481559536354
2024-11-27,931000,956000,929000,953000,83471,22000,2.3630504833512354
2024-11-28,958000,1000000,947000,1000000,121183,42000,4.3841336116910234
2024-11-29,1002000,1007000,973000,975000,83244,-27000,-2.694610778443114
2024-12-02,988000,995000,965000,971000,50880,-17000,-1.7206477732793521
2024-12-03,983000,991000,964000,967000,85347,-16000,-1.627670396744659
2024-12-04,953000,971000,941000,961000,90430,8000,0.8394543546694648
2024-12-05,964000,981000,963000,964000,47093,0,0.0
2024-12-06,970000,984000,956000,962000,79185,-8000,-0.8247422680412372
2024-12-09,942000,975000,941000,953000,118678,11000,1.167728237791932
2024-12-10,962000,966000,946000,959000,86078,-3000,-0.31185031185031187
2024-12-11,955000,965000,946000,949000,68819,-6000,-0.6282722513089005
2024-12-12,955000,980000,944000,958000,120889,3000,0.31413612565445026
2024-12-13,959000,995000,950000,986000,76812,27000,2.815432742440042
2024-12-16,997000,1000000,979000,999000,65335,2000,0.20060180541624875
2024-12-17,997000,999000,973000,974000,60499,-23000,-2.3069207622868606
2024-12-18,978000,986000,966000,980000,40807,2000,0.2044989775051125
2024-12-19,965000,980000,955000,958000,71356,-7000,-0.7253886010362695
2024-12-20,947000,948000,908000,939000,100460,-8000,-0.8447729672650475
2024-12-23,946000,956000,940000,949000,33263,3000,0.3171247357293869
2024-12-24,953000,958000,930000,938000,40596,-15000,-1.5739769150052465
2024-12-26,938000,952000,933000,937000,37570,-1000,-0.10660980810234541
2024-12-27,933000,940000,920000,934000,35257,1000,0.10718113612004287
2024-12-30,935000,969000,932000,949000,52104,14000,1.4973262032085561
